Aa, Aa, Aa, Aa, Aa, Aa, Aa, Aa, Aa, Aa, Aa, Aa, Aa^Fpa, Aa^Fpa, Aa^Fpa, Aa^Fpa, Aa^Fpa, Aa^Fpa, Aa, Ww, Ww, Ww, Ww, Ww, Aa^Fpa, Aa^Fpa, Aa, Aa, Aa, Aa, Aa, Aa, Ha, Ha, Ms, Ms, Ms, Ms, Re, Re
Aa, Aa, Aa, Aa, Aa, Aa, Aa, Aa, Aa, Aa, Aa, Aa, Aa^Fpa, Aa^Fpa, Aa^Fpa, Aa^Fpa, Aa^Fpa, Aa^Fpa, Aa, Ww, Ww, Ww, Ww, Ww, Aa^Voa, Aa^Fpa, Aa, Aa, Aa, Aa, Aa, Aa, Ha, Ha, Ms, Ms, Re, Re, Ha, Ms
Aa, Aa, Aa, Aa, Aa, Aa, Aa, Aa, Aa, Aa, Aa, Aa, Aa^Fpa, Aa^Fpa, Aa^Fpa, Aa^Fpa, Aa^Fpa, Aa^Fpa, Aa^Fpa, Aa, Ww, Ww, Ww, Aa^Fpa, Aa^Fpa, Aa^Fpa, Aa, Aa, Aa, Aa, Aa, Aa, Aa, Ha, Re, Re, Ha, Ha, Ha, Ha
Aa, Aa, Aa, Aa, Aa, Aa, Aa, Aa, Aa, Aa, Aa, Aa, Aa, Aa^Fpa, Aa^Fpa, Aa^Fpa, Aa^Fpa, Aa^Fpa, Aa, Aa, Aa, Ww, Ww, Aa^Fpa, Aa, Aa, Aa, Aa, Aa, Aa, Aa^Fpa, Aa, Aa, Aa, Re, Ha, Ha, Ha, Ha, Ha
Rra, Rra, Rra, Rra, Rra, Aa, Aa, Aa, Aa, Aa, Aa^Vca, Aa, Aa, Aa^Fpa, Aa^Fpa, Aa^Fpa, Aa, Aa^Fpa, Aa^Fpa, Aa, Aa, Ai, Ai, Aa, Aa, Aa, Aa, Aa^Fpa, Aa, Aa^Fpa, Aa, Aa, Aa, Aa, Re, Ha, Aa, Ha, Ms, Ms
Aa, Aa, Aa, Aa, Aa, Rra, Aa, Aa, Aa, Aa, Aa, Aa, Aa, Aa, Aa, Aa, Aa, Aa, Aa, Aa, Aa^Gvs, Ai, Ai, Aa, Aa, Aa^Fpa, Aa^Fpa, Aa^Fpa, Aa^Fpa, Aa^Fpa, Aa, Aa, Aa, Re, Aa, Aa, Aa, Ha, Ha^Voa, Ms
Aa, Aa, Aa, Aa, Aa, Rra, Rra, Aa, Aa, Aa, Aa^Fpa, Aa, Aa^Fpa, Aa, Aa, Aa, Aa^Gvs, Aa^Gvs, Aa^Gvs, Aa^Gvs, Aa^Gvs, Ww, Ww, Aa, Aa, Aa^Fpa, Aa^Fpa, Aa, Aa^Fpa, Aa, Aa^Fpa, Aa, Aa, Re, Aa, Aa, Ha, Ms, Ms, Ms
Aa, Aa, Aa, Aa, Aa, Aa^Vca, Rra, Aa, Aa, Aa, Aa, Aa^Fpa, Aa^Fpa, Aa^Fpa, Aa^Fpa, Aa^Fpa, Aa, Aa^Gvs, Aa^Gvs, Aa^Gvs, Aa, Ww, Ww, Aa, Aa, Aa, Aa, Aa^Fpa, Aa^Fpa, Aa^Voa, Aa, Aa, Re, Re, Aa, Aa, Aa, Ha, Ha, Ha
Aa, Aa, Aa, Aa, Aa, Aa, Rra, Aa^Gvs, Aa^Gvs, Aa^Gvs, Aa, Aa, Aa, Aa, Aa, Aa, Aa^Gvs, Aa, Aa, Aa, Aa^Gvs, Ww, Aa^Gvs, Aa^Gvs, Aa^Gvs, Aa, Aa, Aa, Aa, Aa^Fpa, Rb, Re, Aa, Aa, Aa, Aa, Aa, Ha, Ha, Ha
Aa^Fpa, Aa^Fpa, Aa^Fpa, Aa, Aa, Aa, Aa^Gvs, Rra, Aa^Gvs, Aa^Gvs, Rra, Aa^Gvs, Aa^Gvs, Aa^Gvs, Aa, Aa, Aa^Gvs, Aa^Gvs, Aa^Gvs, Aa^Gvs, Aa^Gvs, Ww, Ww, Aa^Gvs, Aa^Gvs, Aa^Gvs, Aa^Gvs, Aa^Gvs, Rb, Rb, Aa, Aa, Aa, Aa, Aa, Aa, Aa, Ha, Ha, Ha
Aa^Fpa, Aa^Fpa, Aa, Aa, Aa^Gvs, Aa, Aa, Rra, Rra, Rra, Aa^Fpa, Rra, Aa^Voa, Aa^Gvs, Rra, Aa, Rra, Aa^Gvs, Aa^Gvs, Aa^Gvs, Ww, Ww, Ai, Ww, Aa^Gvs, Aa^Gvs, Rb, Rb, Aa^Gvs, Ha, Ha, Aa, Aa, Aa, Aa^Gvs, Aa, Ha^Voa, Aa, Ha, Ha
Aa^Fpa, Aa^Fpa, Aa^Fpa, Aa, Aa^Gvs, Aa^Gvs, Aa^Gvs, Aa, Aa^Fpa, Aa^Fpa, Aa^Fpa, Rra, Rra, Rra, Aa, Rra, Aa, Rra, Rra, Ww, Ai, Ai, Coa, Ww, Ai, Rb, Aa^Gvs, Aa^Gvs, Aa^Gvs, Ha, Aa, Ha, Aa, Aa, Aa^Gvs, Ha, Ha, Ha, Ha, Ha
Aa^Fpa, Aa^Fpa, Aa, Aa^Gvs, Re, Aa^Gvs, Aa^Gvs, Aa, Re, Aa^Fpa, Aa, Aa^Gvs, Aa^Gvs, Aa^Gvs, Aa, Aa, Aa^Gvs, Aa^Gvs, Aa^Gvs, Ai^Bw\, Rb, Coa, Coa, Coa, Ai, Aa^Gvs, Aa^Gvs, Aa^Gvs, Aa, Aa, Aa, Aa, Aa^Gvs, Aa^Gvs, Aa^Gvs, Ha, Ha, Ha, Ha, Ha
Re, Re, Re, Re, Re, Re, Re, Re, Aa^Gvs, Re, Re, Aa, Aa, Aa, Aa^Gvs, Aa^Gvs, Aa^Gvs, Aa^Gvs, Ww, Ww, Ha^Voa, Coa, Ha, Coa, Ww, Aa^Gvs, Aa^Gvs, Aa^Gvs, Aa^Gvs, Aa^Gvs, Aa^Gvs, Aa^Gvs, Aa^Gvs, Aa^Gvs, Re, Ha, Aa, Ha, Ha, Ha
Re, Re, Re, Re, Aa^Gvs, Aa^Gvs, Aa^Fpa, Aa^Gvs, Aa^Fpa, Aa^Fpa, Re, Re, Re, Aa^Gvs, Aa^Gvs, Aa^Gvs, Ww, Ww, Coa, Coa, Coa, Coa, Ha, 2 Koa, Coa, Ww, Ww, Aa^Gvs, Ww, Aa^Gvs, Aa^Gvs, Aa^Gvs, Re, Re, Aa^Gvs, Aa^Gvs, Aa^Gvs, Aa, Ha, Ha
Aa^Fpa, Aa^Fpa, Aa^Fpa, Aa^Gvs, Aa, Aa, Aa^Fpa, Aa^Fpa, Re, Re, Re, Aa, Aa^Gvs, Re, Re, Ai, Ai, Rb, Coa, Coa, Coa, Ha^Voa, Ha^Voa, Ha, Coa, Coa, Ha^Vca, Ww, Aa^Gvs, Ww, Ww, Aa^Gvs, Ai, Aa^Gvs, Aa^Gvs, Aa^Gvs, Aa, Aa, Ha, Ha
Aa^Fpa, Aa^Fpa, Aa^Fpa, Aa^Fpa, Aa, Aa, Re, Re, Aa, Aa, Aa, Aa^Fpa, Aa^Fpa, Aa^Gvs, Re, Ai, Ww, Ha, Ha, Koa, Coa, Ha, Coa, Coa, Coa, Coa, Ha, Aa^Gvs, Aa^Gvs, Aa^Gvs, Rb, Ai, Re, Ww, Ww, Aa, Ha, Ha, Wo, Wo
Aa^Fpa, Aa^Fpa, Aa, Aa, Re, Re, Aa, Aa, Aa^Fpa, Aa, Aa^Fpa, Aa^Fpa, Aa^Fpa, Aa^Gvs, Re, Ww, Ww, Ai, Ha, Aa^Gvs, Ha, Coa, Ha, Coa, Rb, Ha, Ha, Aa^Gvs, Rb, Rb, Aa^Gvs, Aa^Vca, Aa^Gvs, Aa^Gvs, Aa^Gvs, Ww, Wo, Wo, Rb, Rb
Aa^Fpa, Aa^Fpa, Aa, Re, Aa, Aa, Aa^Fpa, Aa^Fpa, Aa^Fpa, Aa^Fpa, Aa^Fpa, Aa^Fpa, Aa, Aa^Gvs, Re, Ai, Ww, Ai, Ai, Aa^Gvs, Aa^Gvs, Aa^Gvs, Aa^Gvs, Aa^Gvs, Aa^Gvs, Rb, Rb, Rb, Aa^Gvs, Aa^Gvs, Aa^Gvs, Aa^Gvs, Rb, Aa^Gvs, Aa^Gvs, Aa^Gvs, Rb, Rb, Aa, Aa
Aa, Aa, Aa, Re, Aa, Aa^Fpa, Aa^Fpa, Aa^Fpa, Aa, Aa^Fpa, Aa^Fpa, Aa^Fpa, Re, Re, Ww, Ww, Aa^Fpa, Ww, Ai, Aa^Gvs, Aa^Fpa, Aa^Gvs, Aa^Gvs, Aa^Gvs, Aa^Gvs, Aa^Gvs, Aa^Gvs, Rb, Rb, Aa^Gvs, Rb, Rb, Aa^Gvs, Rb, Rb, Rb, Aa, Aa, Ha, Ha
Aa^Fpa, Aa^Fpa, Aa, Re, Re, Aa, Aa, Aa^Voa, Aa, Aa, Aa, Aa, Re, Aa, Ww, Aa^Fpa, Aa^Fpa, Ww, Ai, Aa, Aa^Fpa, Aa^Gvs, Aa^Fpa, Aa^Gvs, Aa, Aa^Gvs, Aa^Gvs, Aa^Gvs, Rb, Rb, Aa^Gvs, Aa^Gvs, Aa^Gvs, Rb, Aa^Gvs, Aa^Gvs, Aa, Aa, Ha, Ha
Aa^Fpa, Aa^Fpa, Aa, Aa^Fpa, Re, Aa, Aa^Fpa, Aa, Aa^Fpa, Aa^Fpa, Aa^Fpa, Aa, Re, Aa, Ww, Aa^Fpa, Aa^Fpa, Ww, Ww, Aa, Aa, Aa^Fpa, Aa^Fpa, Aa, Aa, Aa, Aa^Gvs, Aa^Gvs, Rb, Aa^Gvs, Aa^Gvs, Aa^Gvs, Aa^Gvs, Aa^Gvs, Aa, Aa^Gvs, Ha, Ha, Ha, Ha
Aa^Fpa, Aa^Fpa, Aa^Fpa, Aa^Fpa, Re, Aa^Fpa, Aa^Fpa, Aa^Fpa, Aa, Aa^Fpa, Aa^Fpa, Aa^Voa, Re, Aa, Ww, Aa^Fpa, Aa^Fpa, Aa^Fpa, Ww, Aa, Aa, Aa^Fpa, Aa, Aa, Aa, Aa, Aa^Gvs, Aa^Gvs, Rb, Aa^Gvs, Aa^Gvs, Aa^Gvs, Aa^Gvs, Aa^Gvs, Aa^Gvs, Aa, Ha, Ha, Ha, Ha
Aa^Fpa, Aa^Fpa, Aa^Fpa, Aa^Fpa, Re, Aa^Fpa, Aa^Fpa, Aa, Aa^Fpa, Aa, Re, Re, Aa, Ai^Bw\, Aa, Aa, Aa^Fpa, Aa^Fpa, Ww, Aa, Aa, Aa, Aa, Aa, Aa^Voa, Aa^Gvs, Aa^Gvs, Aa^Gvs, Re, Re, Re, Re, Re, Aa^Gvs, Aa^Gvs, Aa^Gvs, Ha, Ha, Ha, Ha
Aa^Fpa, Aa^Fpa, Aa^Fpa, Re, Aa^Fpa, Aa^Fpa, Aa^Fpa, Aa^Fpa, Aa, Re, Aa, Aa, Ww, Ww, Aa, Aa, Aa, Aa^Fpa, Aa, Aa, Aa, Aa, Aa^Fpa, Aa^Fpa, Aa^Gvs, Aa^Gvs, Re, Re, Aa^Gvs, Aa^Gvs, Aa^Gvs, Aa^Gvs, Aa^Gvs, Re, Ha, Ha, Ha, Ha, Ms, Ms
Aa^Fpa, Aa^Fpa, Aa^Fpa, Re, Aa^Fpa, Aa^Fpa, Aa^Fpa, Aa^Fpa, Aa^Fpa, Re, Aa, Ww, Ww, Aa, Aa, Aa, Aa, Aa, Aa, Aa, Aa^Fpa, Aa^Fpa, Aa, Aa^Fpa, Aa^Gvs, Aa^Gvs, Re, Aa^Gvs, Aa^Gvs, Aa^Gvs, Aa^Gvs, Aa^Gvs, Aa^Gvs, Ha, Ha, Ha, Ms, Ha, Ms, Ms
Aa^Fpa, Aa^Fpa, Re, Re, Re, Aa^Fpa, Aa^Fpa, Aa^Fpa, Aa^Fpa, Re, Aa, Ww, Aa, Aa, Aa, Aa, Aa, Aa^Vca, Aa, Aa, Aa^Fpa, Aa^Fpa, Aa, Aa, Aa, Aa, Re, Aa^Gvs, Aa, Aa, Aa, Aa, Aa, Ha, Ha, Ms, Ms, Ms, Ms, Ms
Re, Re, Aa^Fpa, Aa^Fpa, Aa^Fpa, Re, Re, Re, Re, Re, Aa, Ww, Aa, Aa^Fpa, Aa^Fpa, Aa, Aa, Aa, Aa, Aa, Aa, Aa, Aa, Aa, Aa, Aa, Re, Aa, Ha, Aa, Aa, Aa, Ha, Ha, Ha, Ha, Ha, Ms, Ms, Ms
Aa^Fpa, Aa^Fpa, Aa^Fpa, Aa^Fpa, Aa^Fpa, Aa^Fpa, Aa^Fpa, Aa, Aa, Aa, Aa, Ww, Ww, Aa^Fpa, Aa^Fpa, Aa^Fpa, Aa^Fpa, Aa, Aa, Aa, Aa, Aa, Aa, Aa, Re, Re, Aa, Aa, Ha, Ha, Ha, Ha, Ha, Ha, Ha, Ha, Ha, Ha, Ms, Ms
Aa^Fpa, Aa^Fpa, Aa^Fpa, Aa^Fpa, Aa^Fpa, Aa^Fpa, Aa^Vca, Aa^Fpa, Aa, Aa, Ww, Ww, Aa, Aa, Aa, Aa^Fpa, Aa, Aa, Aa, Aa, Aa, Aa, Aa, Aa^Voa, Re, Aa, 1 Aa, Aa, Aa, Ha^Vca, Ha, Ha, Ha, Ha, Ms, Ms^Vca, Ms, Ms, Ms, Ms
Aa, Aa^Vca, Aa, Aa^Fpa, Aa^Fpa, Aa^Fpa, Aa, Aa, Aa, Aa^Fpa, Ww, Ww, Aa, Aa, Aa, Aa^Fpa, Aa, Aa, Aa, Aa, Aa, Aa, Aa, Re, Aa, Aa, Aa, Aa, Ha, Ha, Ha, Ha, Ms, Ms, Ms, Ms, Ms, Ms, Ms, Ms
Aa, Aa, Aa, Aa^Fpa, Aa^Fpa, Aa^Fpa, Aa, Aa, Aa, Aa^Fpa, Ww, Ww, Aa, Aa, Aa, Aa^Fpa, Aa, Aa, Aa, Aa, Aa, Aa, Aa, Re, Aa, Aa, Aa, Aa, Ha, Ha, Ha, Ha, Ms, Ms, Ms, Ms, Ms, Ms, Ms, Ms
