Aa, Aa, Aa, Aa, Aa, Rr, Aa, Ai, Ai, Aa, Ms, Ms, Ms^Xm, Ms, Ms, Aa, Ms, Aa, Ms, Aa, Ms, Ms, Ms, Aa^Fpa, Ai, Aa, Rra, Rra
Aa, Aa, Aa, Aa, Rr, Rr, Aa, Ai, Ai, Aa^Esa, Ms, Ms, Ms^Xm, Ms^Xm, Ms, Ms, Ms, Ms, Aa^Fpa, Ms, Ai, Aa, Ai, Ai, Rr, Ai^Bsa/, Ai, Ai
Aa, Aa, Aa, Aa, Rr, Aa, Aa, Ai, Aa, Aa^Esa, Ms, Ms, Ms, Ms, Ms, Ms, Aa^Fma, Ms, Ai, Ai, Aa, Ai, Rra, Rra, Aa, Aa, Aa^Fpa, Ms
Aa, Aa, Aa, Aa, Rr, Aa, Aa, Ai, Ai, Aa^Esa, Aa^Esa, Ms, Ms, Ms, Aa^Fma, Aa^Fma, Aa^Fma, Aa^Fma, Ai, Ai, Ch, Ch, Aa, Aa, Aa, Aa, Aa^Fpa, Ms
Aa, Aa, Rr, Ch, Ch, Aa, Aa, Aa, Ai, Ai, Ai, Ms, Ms, Ms, Aa^Fma, Aa^Fma, Ai, Ai, Aa, Aa, Ch, Kh, Aa, Aa, Aa, Aa, Aa^Fpa, Ms
Aa, Rr, Aa, Ch, Kh, Aa, Rr^Esa, Rra, Rra, Ai, Ai, Aa^Fma, Aa^Fma, Aa^Feta, Ai, Ai, Ai, Ai, Rra, Rra, Aa, Aa, Aa, Aa, Aa^Fpa, Aa^Fpa, Aa^Fpa, Ms
Rr, Rr^Esa, Aa, Aa, Aa, Rr, Aa, Aa, Aa, Rra, Rra, Ai, Ai, Ai, Aa, Ai, Aa^Fma, Aa, Rr, Aa, Aa, Aa, Aa, Aa^Fpa, Aa^Fpa, Aa^Fpa, Ms, Ms
Aa, Aa, Aa, Aa, Aa, Aa, Ms, Aa, Aa, Aa, Aa^Fda, Rra, Rra, Ai, Rra, Aa, Rra, Rr, Aa, Aa, Aa, Aa, Aa^Esa, Aa^Fpa, Ms, Ms, Ms, Ms
Aa, Aa, Ms, Ms, Ms, Ms, Ms, Ms, Ms, Aa^Fda, Aa^Fda, Aa^Fda, Aa, Rra, Aa, Rra, Aa^Fpa, Aa, Aa, Aa, Aa, Aa, Ms, Ms, Ms, Ms, Ms^Xm, Ms
Aa, Ms, Ms, Ms, Ms, Ms, Ms, Ms, Ms, Aa^Fda, Aa^Fda, Aa^Fda, Aa^Fpa, Rr, Aa^Fda, Aa^Fpa, Aa^Fpa, Aa^Fpa, Aa^Fpa, Aa^Fpa, Aa^Fpa, Ms, Ms, Ms, Ms^Xm, Ms^Xm, Ms^Xm, Ms^Xm
Aa, Ms^Xm, Ms, Ms, Ms, Ms, Ms, Ms, Ms, Aa^Fda, Aa^Fda, Aa^Fda, Aa^Fda, Rra, Aa^Fda, Aa^Fma, Aa^Fma, Aa^Fpa, Aa^Fpa, Aa^Fpa, Aa^Fpa, Ms, Ms, Ms, Ms^Xm, Ms^Xm, Ms^Xm, Ms^Xm
Aa, Ms^Xm, Ms^Xm, Ms, Ms, Ms, Ms, Ms, Ms, Ms, Aa^Fda, Aa^Fma, Aa^Fma, Rra, Rra, Aa^Fda, Rra, Aa^Fpa, Aa^Fma, Aa^Fpa, Aa^Fpa, Aa^Fpa, Aa^Fpa, Ms, Ms, Ms^Xm, Ms^Xm, Ms^Xm
Ms^Xm, Ms^Xm, Ms^Xm, Ms, Ms, Ms, Ms, Ms, Ms, Ms, Aa^Fda, Aa^Fma, Aa^Fpa, Aa^Fpa, Aa^Fda, Rra, Aa, Rra, Aa^Fda, Aa^Fma, Aa^Fpa, Aa^Fpa, Aa^Fpa, Ms, Ms, Ms, Ms, Ms
Ms^Xm, Ms^Xm, Ms, Ms, Ms, Ms, Ms, Ms, Ms, Ms, Ms, Aa^Fpa, Aa^Fpa, Aa^Fda, Aa^Fda, Aa, Aa, Rra, Rra, Aa^Fda, Aa^Fpa, Aa^Fpa, Aa^Fpa, Aa^Fpa, Ms, Ms, Ms, Ms
Aa, Ms, Ms, Ms, Ms, Ms, Ms, Ms, Ms, Ms, Ms, Ms, Ms, Aa^Fda, Aa^Esa, Aa, Aa, Aa, Aa, Rr, Aa^Fpa, Aa^Fpa, Aa^Fpa, Aa^Fpa, Aa^Fpa, Ms, Ms, Ms
Ms, Ms, Ms, Ms, Ms^Xm, Ms^Xm, Ms^Xm, Ms, Ms, Ms, Ms, Ms, Ms, Ms, Aa^Esa, Aa, Aa^Esa, Aa^Esa, Aa, Rr, Aa^Fda, Aa^Fpa, Aa^Fpa, Aa^Fpa, Aa^Fpa, Ms, Ms, Ms
Ms, Ms, Ms^Xm, Ms^Xm, Ms^Xm, Ms^Xm, Ms, Ms, Ms, Ms, Ms, Ms, Ms, Ms, Ms, Aa^Esa, Aa, Aa, Aa, Rra, Rr, Aa^Fpa, Aa^Fpa, Aa^Fpa, Aa^Fpa, Ms, Ms, Ms
Ms, Ms, Ms^Xm, Ms^Xm, Ms, Ms, Ms, Ms, Ms, Ms, Ms, Ms, Ms, Ms, Ms, Ms, Aa, Aa, Aa, Aa, Aa, Rra, Aa^Fma, Aa^Fpa, Aa^Fma, Ms, Ms, Ms
Ms, Ms, Ms, Ms, Aa, Ms, Aa, Ms, Aa, Ms, Ms, Ms, Ms, Ms, Ms, Ms, Aa^Fda, Aa^Fda, Aa^Fda, Aa, Rr, Rra, Aa, Aa^Fma, Aa^Fda, Aa^Fda, Ms, Ms
Ms, Ms, Ms, Aa^Fma, Aa, Ai, Ai, Ai, Aa, Ms, Ms, Ms, Ms, Ms, Ms, Ms, Aa^Fma, Aa^Fda, Aa^Fda, Aa, Rr^Esa, Ch, Ch, Aa^Fda, Aa^Fda, Aa^Fda, Ms, Ms
Ms, Ms, Ms, Ms, Aa, Ai, Ai, Ai, Aa, Ms, Ms, Ms, Ms, Ms, Ms, Ms, Aa^Fpa, Aa^Fma, Aa^Fma, Aa, Rr, Ch, Kh, Aa, Aa, Aa, Ms, Ms
Ms, Ms, Ms, Ms, Ms, Aa, Aa, Ai, Ai, Ms, Ms, Ms, Ms, Ms, Ms, Ms, Aa^Fpa, Aa^Fpa, Aa^Fma, Aa, Aa, Rra, Rra, Aa, Aa, Aa^Fpa, Ms, Ms
Ms, Ms, Ms, Ms, Ms, Ms, Ms, Ms, Ms, Aa, Aa, Ms, Ms, Ms, Aa^Fpa, Aa^Fpa, Aa^Fpa, Aa^Fpa, Aa, Aa, Aa, Rra, Aa, Aa, Aa^Fpa, Ms, Ms, Ms
Ms, Ms, Ms, Ms, Ms, Ms, Ms, Ms, Ms, Ms, Ms, Ai, Aa, Aa^Fpa, Aa^Fpa, Aa^Fpa, Aa^Fpa, Aa^Fpa, Aa, Aa, Rr, Rra, Aa, Aa, Aa^Fpa, Ms, Ms, Ms
Ms, Ms, Ms, Ms, Ms, Ms, Ms, Ms, Ms, Ms, Ms, Ms, Ai, Aa^Fpa, Aa^Fpa, Aa^Fpa, Aa, Aa, Rr, Rr, Aa, Aa, Aa^Fpa, Aa^Fpa, Aa^Fpa, Ms, Ms, Ms
Ms, Ms, Ms, Ms, Ms, Ms, Ms, Ms, Ms, Ms, Ms, Ai, Aa^Esa, Aa, Aa, Aa, Aa, Aa, Rr, Aa, Aa, Aa^Fpa, Aa^Fpa, Aa^Fpa, Ms, Ms, Ms, Ms
Gs^Fp, Ms, Ms, Ms, Ms, Ms, Ms, Ms, Ms, Ms, Aa, Ai, Aa, Aa, Aa, Aa, Aa, Rra, Aa, Aa, Aa, Aa^Fpa, Aa^Fpa, Ms, Ms, Ms, Ms, Ms
