Gg, Gg, Gs^Fp, Gs^Fp, Gs^Fp, Gg, Gg, Gg, Rr, Rr, Gg, Gg, Gg, Ss, Gs^Fp, Gg, Gg, Gg, Gs^Fp, Gs^Fp, Hh, Hh, Mm, Hh, Gs^Fp, Gs^Fp, Gs^Fp, Gs^Fp
Gg, Gg, Gg, Gg, Gg, Ds, Rr, Rr, Gg, Gs^Fp, Gg, Gg, Ss, Gs^Fp, Gg, Gg, Aa, Gg, Gg, Gs^Fp, Gs^Fp, Gs^Fp, Gs^Fp, Gs^Fp, Gg, Gg, Gg, Gs^Fp
Gs^Fp, Gg, Gg, Gg, Rr, Rr, Aa, Gg, Gg, Gs^Fp, Ss, Ss, Gs^Fp, Gs^Fp, Gg, Gg, Aa, Gg, Gg, Gg, Gs^Fp, Gs^Fp, Gs^Fp, Gs^Fp, Gg, Gg, Gs^Fp, Gs^Fp
Gs^Fp, Gs^Fp, Gg, Gg, Rr, Ds, Ds, Gg, Gg, Ds, Ds, Ds, Gs^Fp, Gg, Gg, Aa, Aa, Gg, Gg, Gg, Ch, Ch, Gs^Fp, Gs^Fp, Gs^Fp, Gs^Fp, Gs^Fp, Gs^Fp
Gg, Gs^Fp, Rr, Ch, Ch, Gg, Gg, Gg, Gg, Gg, Gs^Fp, Gs^Fp, Gs^Fp, Gg, Gg, Aa, Aa, Aa, Aa, Gg, Ch, Kh, Gs^Fp, Gs^Fp, Gs^Fp, Gs^Fp, Gs^Fp, Gs^Fp
Gg, Rr, Gs^Fp, Ch, Kh, Gg, Rr, Rr, Rr, Gg, Gs^Fp, Gs^Fp, Gs^Fp, Gg, Gg, Gg, Aa, Aa, Gg, Gg, Gg, Gg, Gs^Fp, Gs^Fp, Gg, Gs^Fp, Gs^Fp, Gs^Fp
Rr, Rr, Gs^Fp, Gs^Fp, Gs^Fp, Rr, Gg, Gg, Gg, Rr, Rr, Gs^Fp, Gs^Fp, Gg, Gg, Gg, Gg, Gg, Gg, Gg, Gs^Fp, Gg, Gs^Fp, Gs^Fp, Gg, Ss, Gs^Fp, Gs^Fp
Gg, Gs^Fp, Gs^Fp, Gs^Fp, Gs^Fp, Gs^Fp, Gg, Gs^Fp, Gs^Fp, Gg, Gg, Rr, Rr, Gg, Gg, Gg, Gg, Gg, Gg, Gg, Gg, Gg, Gs^Fp, Gs^Fp, Gs^Fp, Gs^Fp, Ss, Gs^Fp
Gg, Gs^Fp, Gs^Fp, Gs^Fp, Gs^Fp, Gs^Fp, Gs^Fp, Gs^Fp, Gs^Fp, Gs^Fp, Gs^Fp, Gs^Fp, Gs^Fp, Rr, Gg, Ds, Ds, Gg, Gg, Gg, Gg, Gg, Gs^Fp, Gs^Fp, Gs^Fp, Gg, Ss, Gs^Fp
Gg, Gs^Fp, Gs^Fp, Gs^Fp, Gs^Fp, Gs^Fp, Gs^Fp, Gs^Fp, Gs^Fp, Gs^Fp, Gs^Fp, Gs^Fp, Gg, Rr, Gg, Ds, Gg, Gg, Gg, Gg, Gg, Gs^Fp, Gs^Fp, Gs^Fp, Gs^Fp, Gs^Fp, Gs^Fp, Gs^Fp
Gs^Fp, Gs^Fp, Gs^Fp, Gs^Fp, Gs^Fp, Gs^Fp, Gs^Fp, Gs^Fp, Gs^Fp, Gs^Fp, Gs^Fp, Gs^Fp, Gg, Rr, Gg, Ds, Gg, Gg, Gg, Gg, Gs^Fp, Gs^Fp, Gs^Fp, Gs^Fp, Gs^Fp, Gg, Gg, Gg
Hh, Hh, Hh, Gs^Fp, Gs^Fp, Gs^Fp, Gs^Fp, Gs^Fp, Gs^Fp, Gs^Fp, Gg, Gg, Gg, Rr, Rr, Ds, Rr, Gg, Gg, Gg, Gs^Fp, Gs^Fp, Gs^Fp, Gs^Fp, Gg, Gg, Gg, Gg
Hh, Hh, Hh, Gg, Gg, Gg, Gg, Gg, Gg, Gg, Gg, Gg, Gg, Aa, Gg, Rr, Gg, Rr, Gg, Gg, Gs^Fp, Gs^Fp, Gs^Fp, Gg, Gg, Gg, Gg, Ww
Mm, Ha, Ha, Hh, Gg, Gg, Gg, Gg, Gg, Aa, Aa, Aa, Aa, Gg, Gg, Ds, Gg, Rr, Rr, Gg, Gg, Gg, Gg, Gg, Ww, Ai, Ww, Ww
Mm, Ha, Ha, Aa, Aa, Aa, Gg, Gg, Gg, Aa, Aa, Aa, Aa, Gg, Gg, Gg, Gs^Fp, Gs^Fp, Gs^Fp, Rr, Gg, Gg, Gg, Gg, Gg, Gg, Ww, Ww
Mm, Ha, Ha, Gg, Gg, Gg, Gg, Gg, Gg, Aa, Aa, Ha, Gg, Gg, Gg, Gs^Fp, Ss, Ss, Gs^Fp, Rr, Gg, Aa, Aa, Aa, Gg, Ww, Ww, Ww
Hh, Ha, Aa, Gg, Gg, Gg, Gg, Hh, Hh, Ha, Mm, Hh, Gg, Gs^Fp, Gs^Fp, Gs^Fp, Gs^Fp, Gs^Fp, Gs^Fp, Rr, Rr, Aa, Aa, Gg, Gg, Ww, Ww, Ww
Rr, Ha, Aa, Gg, Gg, Gs^Fp, Gs^Fp, Hh, Mm, Mm, Mm, Hh, Gs^Fp, Gs^Fp, Gs^Fp, Gs^Fp, Gs^Fp, Gs^Fp, Gs^Fp, Gs^Fp, Gg, Rr, Gg, Gg, Hh, Ww, Ww, Ww
Rr, Aa, Ha, Hh, Hh, Hh, Hh, Mm, Mm, Mm, Mm, Hh, Gs^Fp, Gs^Fp, Gs^Fp, Gs^Fp, Gg, Gs^Fp, Gs^Fp, Gs^Fp, Gg, Rr, Gg, Gg, Mm, Ww, Ww, Mm
Rr, Gg, Hh, Hh, Hh, Hh, Mm, Mm, Mm, Mm, Mm, Mm, Gs^Fp, Gs^Fp, Gs^Fp, Gg, Gg, Gg, Gg, Gg, Gg, Ch, Ch, Gg, Hh, Hh, Mm, Ww
Rr, Hh, Hh, Hh, Hh, Hh, Mm, Mm, Mm, Mm, Mm, Hh, Gg, Gs^Fp, Gs^Fp, Gg, Gg, Gg, Gg, Gg, Gg, Ch, Kh, Gg, Gg, Hh, Hh, Hh
Gs^Fp, Rr, Hh, Hh, Hh, Mm, Mm, Mm, Mm, Mm, Mm, Hh, Gg, Gs^Fp, Gs^Fp, Gs^Fp, Gg, Gs^Fp, Gs^Fp, Gg, Gg, Gg, Gg, Gg, Gg, Gg, Gg, Gg
Gg, Rr, Gg, Hh, Mm, Mm, Mm, Mm, Mm, Mm, Mm, Hh, Gg, Gg, Gs^Fp, Gs^Fp, Gs^Fp, Gs^Fp, Gg, Gg, Gg, Aa, Aa, Aa, Aa, Gg, Gg, Ww
Gg, Rr, Gg, Gg, Mm, Mm, Mm, Mm, Mm, Mm, Hh, Hh, Gg, Gg, Gs^Fp, Gs^Fp, Gs^Fp, Gs^Fp, Gg, Gg, Gg, Gg, Gg, Gg, Aa, Gg, Gg, Ww
Gg, Rr, Gg, Gg, Hh, Mm, Mm, Mm, Mm, Mm, Hh, Gg, Gg, Gg, Gs^Fp, Gs^Fp, Gs^Fp, Ww, Gg, Gs^Fp, Hh, Gs^Fp, Gg, Gg, Aa, Gg, Gg, Ww
Gs^Fp, Rr, Rr, Gg, Hh, Mm, Mm, Mm, Mm, Mm, Hh, Hh, Gg, Gg, Ww, Ww, Ww, Ww, Ww, Hh, Hh, Hh, Gg, Gg, Gg, Gg, Gg, Ww
Gs^Fp, Gg, Gs^Fp, Rr, Gs^Fp, Hh, Hh, Mm, Mm, Mm, Ha, Aa, Gg, Gg, Rr, Ww, Ww, Ww, Ww, Ww, Hh, Hh, Gs^Fp, Gg, Gg, Gg, Ww, Ww
