Ms, Ms, Mm, Mm, Mm, Xu, Xu, Mm, Xu, Xu, Xu, Uue, Tb^Qhh, Uue^Qhh, Uu^Qhh, Uue^Qhh, Uue^Qhh, Xu, Xu, Ur, Isa^Qhu, Isa^Qhu, Cud, Isa^Qhu, Isa^Qhu, Uu, Uue, Uue, Uue, Uue, Xu, Uue, Xu, Xu, Ms, Ms
Ms, Ms, Mm, Mm, Hh, Hh^Es, Mm, Xu, Cud, Uu, Urb, Uue, Urb, Uue^Qhh, Uu^Qhh, Uue^Qhh, Urb, Urb, Urb, Isa^Qhu, Cud, Cud, Kud, Cud, Cud, Isa^Qhu, Uu, Uu, Urb, Tb^Tf, Xu, Xu, Xu, Xu, Mm, Ms
Mm, Mm^Es, Mm, Mm, Hh^Efm, Mm, Mm, Xu, Urb, Urb, Xu, Urb, Uue, Urb, Urb, Urb, Xu, Xu, Uue, Isa^Qhu, Isa^Qhu, Cud, Cud, Cud, Isa^Qhu, Isa^Qhu, Urb, Urb, Cud, Urb, Urb, Xu, Mm, Mm, Mm, Mm
Hh, Hh, Hh^Efm, Hh, Mm, Mm, Gs^Ebn, Ur, Mm, Mm, Mm, Xu, Xu, Xu, Cud, Urb, Cud, Xu, Tb^Tf, Uue, Uu, Isa^Qhu, Isa^Qhu, Isa^Qhu, Uue, Uu, Xu, Xu, Xu, Xu, Rb, Ur, Hh, Hh^Dr, Mm, Mm
Gg, Mm, Hh, Gs^Efm, Rb, Hh^Es, Re, Rb, Mm, Mm, Mm, Hh, Mm, Mm, Uu, Urb, Mm, Xu, Cud, Uu, Urb, Urb, Uu, Uu, Uue, Uu, Xu, Xu, Xu, Hh, Rb, Gs^Ebn, Rb, Hh^Es, Hh, Gg
Gg, Mm, Gs, Rb, Mm, Re, Mm, Hh^Efm, Hh^Efm, Hh^Fds, Mm, Hh^Efm, Hh^Dr, Mm, Mm, Ur, Hh, Hh, Ur, Urb, Cud, Tb^Tf, Xu, Xu, Xu, Xu, Xu, Xu, Mm, Mm, Gs^Es, Rb, Mm, Re, Re, Hh
Hh, Hh, Hh, Rb, Hh^Dr, Mm, Mm, Hh, Hh^Fds, Hh, Mm, Hh, Hh^Es, Hh^Dr, Mm, Gs^Efm, Gs, Mm, Rb, Rb, Mm, Xu, Hh, Hh, Gs^Efm, Xu, Hh^Dr, Hh^Dr, Hh, Gs^Efm, Gs, Gs, Mm, Hh^Es, Hh^Es, Rb
Hh, Hh^Fds, Gg^Fds, Re, Gs^Efm, Hh^Efm, Hh, Hh, Hh^Fds, Ww^Ewf, Hh, Hh^Qhh, Hh^Fds, Hh^Efm, Hh, Hh^Efm, Hh^Fds, Rb, Gs^Ebn, Mm, Mm, Mm, Hh^Es, Hh^Fds, Mm, Mm, Hh, Mm, Gs^Qhu, Gs, Gs^Efm, Gs^Qhh, Gs^Efm, Hh, Mm, Mm
Hh, Gg^Fds, Gs, Rb, Re, Gs^Qhu, Hh, Gg^Fds, Wwg, Wo^Ewl, Gs, Gs^Qhh, Gs^Qhh, Hh^Fds, Hh, Hh^Fds, Hh^Fds, Re, Rb, Hh, Hh, Hh, Gs^Efm, Mm, Mm, Mm, Hh, Mm, Mm, Gs^Efm, Mm, Gs, Gg, Hh, Wo, Wo
Hh, Hh, Hh^Efm, Hh, Rb, Gs^Efm, Hh^Fds, Hh^Fds, Wo^Wkf, Hh, Hh^Fds, Gg^Fds, Gs^Efm, Gs, Gg^Fds, Gg^Fds, Hh, Gs, Re, Hh^Fds, Gs^Qhh, Hh, Hh^Fds, Mm, Mm, Hh, Mm, Hh, Gs^Qhu, Gs, Gg, Ss, Wwg^Ewl, Wwg, Hh, Mm
Gg, Mm, Mm, Hh^Fds, Gg^Fds, Rb, Ss, Hh, Wwg, Hh, Hh, Gs, Gs, Gs, Gs^Es, Gs, Rr^Vhc, Rb, Hh, Hh^Efm, Gs^Qhh, Mm, Hh, Gg^Fds, Gs^Efm, Hh, Mm, Mm, Gs, Gg, Wwg, Wwg, Mm, Mm, Hh, Hh
Hh, Mm, Mm, Rb^Vhc, Re, Rb, Wwg, Wo, Sm, Ss, Ss, Gs^Es, Re, Rb, Rb, Gs, Rb, Rb, Re, Gs^Es, Rb, Mm^Efm, Re, Re, Re, Rb, Re, Gs^Efm, Hh^Fds, Hh^Fds, Wwg^Wkf, Hh, Hh, Mm, Hh^Fds, Gg
Gg, Hh^Dr, Hh, Hh^Efm, Rb^Efm, Wo, Sm, Sm, Ss, Sm, Gs, Gs, Rb, Gs^Es, Hh, Re, Hh^Efm, Gs, Hh^Fds, Rb, Hh^Fds, Rb, Hh^Efm, Mm, Mm, Gg^Fds, Mm, Rb, Rb^Efm, Hh, Gs, Wwg^Ewf, Wwg^Wkf, Hh^Fds, Hh^Fds, Gg^Fds
Gg, Hh^Fds, Hh^Fds, Rb, Gg, Wo^Ewl, Wwg^Wkf, Sm, Sm, Gs, Gs^Efm, Gs^Efm, Rb, Hh, Gs, Hh, Hh, Hh, Hh^Fds, Hh, Hh^Fds, Hh^Fds, Hh, Mm, Hh, Gg^Fds, Gg^Fds, Gg^Fds, Gg^Fds, Rb, Rb^Vhc, Gs, Wo, Gg^Fds, Gs^Efm, Gs
Gg^Fds, Hh^Fds, Rb, Re, Ss, Ss, Wwg, Ss, Gs^Qhh, Gs^Qhh, Rb, Rb, Gs, Gs^Efm, Gs, Hh, Hh^Fds, Gs, Gs^Efm, Hh^Efm, Hh^Fds, Mm, Mm, Hh^Es, Hh^Efm, Mm, Hh, Mm, Mm^Es, Gs, Hh, Wwg, Gg^Fds, Gg^Fds, Gg^Fds, Gs
Hh, Gg^Fds, Rb, Gg, Wo^Wkf, Wo, Gg, Gg^Qhh, Gg^Fds, Gs, Rb, Hh, Hh, Gs, Gs^Efm, Hh, Hh^Fds, Hh, Gs^Qhu, Gs^Es, Mm, Hh^Fds, Hh, Mm, Hh, Mm, Hh^Fds, Mm, Mm^Es, Mm, Hh, Wwg, Hh^Fds, Gg^Fds, Gs^Efm, Hh
Gs^Efm, Gs, Re, Wwg, Gg, Gg^Efm, Hh^Fds, Hh^Fds, Hh, Gg^Fds, Rb, Mm, Rr^Vhc, Gs, Gs, Gs, Gs^Es, Gs^Qhu, Hh, Hh, Hh, Hh, Gs^Vhh, Mm, Hh, Hh^Efm, Hh^Dr, Mm, Hh, Hh, Wo, Wwg, Hh^Qhh, Gs^Qhh, Gs^Efm, Gs
Gs, Gs^Efm, Rb, Wwg^Ewf, Wo, Gg^Fds, Hh, Mm, Hh^Es, Gs, Hh, Re, Re, Hh, Hh, Hh^Es, Hh, Mm, Hh, Hh, Mm, Gs, Hh^Fds, Gg^Fds, Hh, Hh^Dr, Mm, Mm, Hh, Hh^Fds, Wwg, Ss, Gg, Hh^Qhh, Gs, Gs
Hh, Mm, Rb^Efm, Gg, Wo, Gg^Fds, Gs^Qhu, Hh^Es, Hh^Es, Hh, Mm, Hh, Rb, Mm, Hh^Fds, Hh^Dr, Mm, Mm, Mm, Mm, Hh, Gs, Hh, Hh, Gs, Hh^Fds, Hh, Hh, Hh^Es, Hh, Hh^Es, Wwg, Gg, Hh, Gg^Fds, Gg^Fds
Hh, Rb^Efm, Gg^Fds, Wwg^Ewl, Mm, Hh, Hh, Hh, Mm, Mm, Gs^Es, Re, Hh^Fds, Gs, Hh^Fds, Hh^Fds, Hh, Mm^Es, Hh^Qhh, Hh^Fds, Hh, Hh, Gs, Gg^Fds, Hh, Gs, Hh, Mm, Hh, Gg, Wwg, Wwg^Ewl, Gg^Es, Gs, Gg^Fds, Hh
Gs^Qhh, Rb, Gg^Es, Wwg, Wwrg, Mm, Hh^Efm, Hh, Hh^Fds, Hh^Efm, Hh, Rb, Gg^Fds, Hh, Gs, Gg^Fds, Gg^Fds, Hh, Hh^Qhh, Hh^Es, Hh, Hh^Fds, Hh^Fds, Hh^Fds, Hh, Hh^Es, Mm, Mm, Hh, Hh, Wo, Gg^Fds, Hh^Fds, Gs^Efm, Gs^Efm, Gs
Rb, Re, Rb, Wwg, Wo^Wkf, Hh^Fds, Gg^Fds, Gs, Gg^Fds, Gs^Efm, Gs^Efm, Rb, Re, Gg^Fds, Gg^Fds, Hh, Gs^Qhh, Hh^Qhh, Gs^Qhh, Hh^Qhh, Mm, Hh, Hh^Vhh, Hh, Hh, Mm, Hh, Hh^Fds, Hh^Fds, Gg, Wo^Ewf, Gg^Fds, Rb^Vhc, Gg^Fds, Re, Rb
Hh, Hh, Rb, Gg, Gg, Wwg, Wwg, Gg^Es, Gg^Fds, Gs^Qhu, Gg^Fds, Hh, Re, Hh, Gg^Fds, Gs, Hh^Fds, Hh^Fds, Hh, Mm, Gs, Hh, Gs^Es, Mm, Mm, Mm, Hh, Gg, Wwg, Gg^Fds, Wwg, Gg, Gs^Es, Rb, Gg^Fds, Gg^Fds
Gs^Fds, Hh, Rb^Vhc, Gg^Fds, Hh, Mm, Wo, Gg^Fds, Gg, Gs^Es, Gg^Fds, Rr^Vhc, Rb, Gg^Fds, Gs, Hh, Hh^Fds, Hh, Hh, Mm, Hh, Hh^Es, Gs, Mm^Es, Hh^Es, Hh, Hh, Wo, Hh, Wwg^Ewl, Mm, Hh^Fds, Hh^Fds, Hh, Hh^Efm, Gg
Mm, Hh^Efm, Hh^Efm, Hh^Fds, Mm, Hh^Fds, Hh^Efm, Wo^Wkf, Gg^Efm, Gs, Hh, Gs, Gs, Rb, Re, Gs, Gg^Gvs, Gg^Gvs, Gg, Mm, Hh, Hh, Hh, Gs^Efm, Gg, Gg, Ss, Wwg, Gg, Hh^Efm, Hh^Efm, Mm, Hh^Es, Mm, Hh, Gg
Mm, Mm, Hh, Gs, Gs, Hh, Gg^Fds, Wwg, Wwg, Hh^Fds, Hh, Hh, Hh^Fds, Gs^Efm, Rb, Gs, Gg, Gg^Gvs, Wo, Gg, Wwg^Wkf, Gg, Hh, Hh, Wwg^Wkf, Wo, Wwg^Wkf, Wwg, Gg^Qhh, Gg^Fds, Hh^Fds, Hh, Hh, Gg^Fds, Mm, Mm
Hh, Hh, Gg^Fds, Gg^Fds, Gg^Fds, Gg^Fds, Hh^Efm, Wwrg, Wwg^Ewf, Hh, Mm, Mm, Mm, Gs, Gs^Efs, Rb^Efs, Wwg^Bsb\, Wo, Rb^Ebn, Wo, Gg, Wwg, Wwg^Ewf, Wwg^Ewl, Sm, Sm, Hh, Gg, Hh^Es, Hh, Hh^Fds, Hh, Gs^Efm, Hh^Fds, Hh^Fds, Hh
Gg^Fds, Gg^Fds, Gs, Gs^Efm, Gs, Hh, Gs^Qhu, Hh, Wo, Hh^Efm, Hh, Hh^Fds, Hh^Fds, Mm, Gs^Efm, Gg^Efm, Wo, Rb, Rb, Ket, Ce, Ss, Sm, Sm^Ewf, Sm, Ss, Hh, Hh, Hh^Fds, Hh^Fds, Gs, Gs, Gg^Fds, Gs, Gg^Fds, Gg^Fds
Hh, Hh^Fds, Hh^Fds, Gs^Efm, Gs, Gs^Es, Gs^Qhu, Gg^Es, Wo, Hh, Gg^Efm, Hh^Fds, Hh^Es, Hh^Dr, Gg, Gg, Wo, Ket, Isa, Isa, Isa^Vhc, Ce, Gs^Vhc, Gs^Dr, Gs^Eff, Gs^Wm, Gs^Efm, Hh, Hh^Fds, Gs^Efm, Gs, Hh^Fds, Hh^Es, Gs^Efm, Gs, Gg^Fds
Hh, Hh^Fds, Hh^Fds, Gg^Fds, Gg^Fds, Gs^Efm, Gg^Gvs, Gg^Gvs, Wwg, Wwrg, Wwrg, Gg^Es, Hh, Gg^Dr, Wwg^Ewf, Gg, Wo, Ce, Isa^Vhc, Isa, Isa, Ket, Gs^Ebn, Gs^Eff, Rb^Gvs, Gs^Eff, Hh^Fds, Hh^Fds, Hh^Es, Hh^Fds, Gg^Fds, Hh, Gs, Rb^Vhc, Rb, Gs
Gs, Hh, Hh^Fds, Hh, Hh, Gs, Gs, Gg^Gvs, Rb^Vhc, Wo^Ewl, Wo^Wkf, Ss, Wo, Wwg, Ce, Wo^Wkf, Ce, Ce, Isa, Isa, Isa, Rb, Rb, Gs^Eff, Gg^Eff, Gg^Eff, Gs^Efm, Hh, Hh, Hh, Hh, Gg^Fds, Gg^Fds, Rb, Gs^Es, Re
Gs, Rb^Vhc, Rb, Re, Re, Rb, Rb, Gs^Fds, Rb, Gg^Fds, Gg^Fds, Wo, Wo^Wkf, Ket, Isa^Vhc, Ce, Isa^Vhc, Isa, Isa, Isa^Vhc, Ce, Ket, Gs^Ebn, Rb, Rb, Re, Re, Gs^Qhu, Rb, Hh^Fds, Hh^Fds, Gg^Fds, Re, Rb, Hh^Es, Gs
Re, Rb, Gg^Fds, Gg^Fds, Gg^Es, Hh, Gg^Fds, Rb, Gg^Gvs, Re, Gs^Efm, Hh, Wo, Wo, Isa, Isa, Isa, Isa, Ce, Ce, Gs^Eff, Gs^Eff, Hh^Eff, Gg^Fds, Gg, Hh^Fds, Gg^Fds, Rb, Hh^Fds, Rb, Re, Rb, Gs, Gs, Gs^Qhu, Gs^Qhu
Gs, Gs^Es, Gs, Gg^Fds, Hh^Fds, Hh^Fds, Hh^Es, Gg^Gvs, Gg^Gvs, Rb, Gs^Ebn, Ce, Isa, Wwg^Bsb/, Wo, Isa, Ket, Ce, Gs^Eff, Gs^Eff, Rb^Emf, Rb^Emf, Hh, Hh^Fds, Gg^Fds, Hh, Hh, Hh, Hh, Gs^Efm, Gg^Fds, Rb, Gs^Efm, Gs^Qhu, Gg^Fds, Gg^Fds
Gs, Hh^Fds, Hh, Hh^Efm, Hh, Hh, Hh, Hh, Rb^Vhc, Re, Rb, Ket, Rb, Isa, Ce, Wo^Wkf, Hh, Hh^Dr, Mm, Gg^Eff, Hh, Hh, Gs, Hh, Mm, Mm, Mm, Mm, Hh, Gs^Qhh, Gs^Qhh, Re, Re, Gs, Hh, Hh
Gs^Fds, Hh, Gs^Efm, Gs, Gg^Fds, Gs, Gs^Eff, Gs^Wm, Gs^Eff, Gs^Eff, Gs^Eff, Re^Efs, Rb^Efs, Ket, Gg, Wo, Wwg, Hh, Gs^Fds, Hh, Hh, Gg^Fds, Gg^Fds, Hh, Mm, Mm, Mm, Mm, Hh, Hh^Efm, Gs, Gs, Rb, Hh^Efm, Gs, Gs
Gs, Hh, Gs, Gs^Es, Gs^Eff, Gg^Eff, Rb^Emf, Gs^Eff, Gs^Eff, Rb^Gvs, Gg^Eff, Gs^Eff, Rb, Gg^Ebn, Ss, Wwg, Wwrg, Gg, Gg^Eff, Gg^Eff, Gg^Eff, Gg^Fds, Gg^Fds, Hh, Hh, Mm, Hh, Hh, Hh, Gs, Rb^Vhc, Rb, Gs^Qhh, Gs^Qhh, Gs^Fds, Hh
Gs, Gs^Es, Gg^Eff, Gs^Eff, Gs^Eff, Rb^Emf, Rb^Emf, Rb^Emf, Gs^Eff, Gg^Eff, Gs^Fds, Gs, Rb, Rb^Vhc, Wo^Wkf, Wwg, Gs^Fds, Gg^Eff, Gs^Eff, Rb^Gvs, Gs^Eff, Rb^Vhc, Rb, Gg^Fds, Hh^Fds, Hh, Gs, Gs, Gs, Gg^Fds, Rb, Re, Gs^Qhh, Gs^Fds, Gs^Es, Gs
Gs^Eff, Gg^Eff, Rb^Gvs, Rb^Gvs, Gs^Eff, Gs^Eff, Gs^Eff, Gs^Eff, Gs, Gs, Gs, Gs, Rb, Gg^Efm, Wwg^Ewl, Wwg, Gg^Eff, Gg^Eff, Rb^Emf, Gs^Eff, Gs^Eff, Gg^Fds, Re^Efm, Hh, Gs, Gg^Fds, Re, Rb, Rb, Re, Hh^Efm, Gs, Gs^Fds, Hh^Es, Gs^Fds, Gs^Fds
Gs^Qhh, Gg^Eff, Gs^Eff, Gg^Eff, Rb^Gvs, Rb^Gvs, Rb^Gvs, Gs^Eff, Gs^Eff, Gs^Fds, Gs, Gs^Efm, Re, Gg^Fds, Wwg, Wo, Gg^Es, Gg^Eff, Gs, Gs^Eff, Gs, Gs, Hh^Efm, Rb, Rb, Rb, Rb, Hh, Gs, Hh, Hh, Gs, Hh, Gs^Fds, Hh, Gs^Fds
Hh^Qhh, Hh^Qhh, Hh^Qhh, Gs^Eff, Gs^Eff, Rb^Gvs, Gg^Eff, Gs^Eff, Hh, Gs, Gs^Es, Gs, Re, Wo, Wwrg, Gg, Gg^Fds, Gs^Efm, Hh^Fds, Hh, Gs, Gg^Fds, Gs^Es, Gs^Qhu, Hh^Efm, Gg^Fds, Rb, Hh^Fds, Hh^Efm, Hh^Es, Mm, Gs^Fds, Hh^Fds, Gs^Fds, Gs^Fds, Hh
Mm, Mm, Mm, Hh^Efm, Hh, Gs^Es, Gs^Efm, Rb^Vhc, Gs, Gs^Efm, Gs^Efm, Hh, Hh^Es, Rb, Wo, Wwg, Wo^Wkf, Gg, Gg, Gs^Fds, Gs, Gs^Efm, Gs^Qhu, Gs^Qhu, Hh, Hh, Re, Gs, Hh, Mm, Mm, Hh^Efm, Gs^Fds, Hh^Fds, Gs^Efm, Gs^Fds
Mm, Mm, Mm, Hh^Efm, Gs^Qhh, Gs, Hh, Rb, Gg^Fds, Gs^Efm, Gs^Efm, Gs^Es, Gs, Rb, Ss, Wwg, Wwg, Wo^Ewf, Gg, Gs^Fds, Gs, Hh, Gs, Gg^Fds, Gs, Re, Gs^Efm, Gs, Gs, Hh^Es, Hh, Gs^Fds, Gs^Fds, Gs^Efm, Hh^Efm, Gs
Hh, Mm, Mm^Efm, Hh, Gg^Fds, Gg^Fds, Rb, Re, Gs, Gs, Hh, Hh^Es, Gg^Fds, Re, Wo, Wwg, Ss, Ss, Gg, Gg^Es, Gg^Es, Gs, Hh, Gs, Ss, Rb, Rb, Gg^Fds, Rb, Gs^Efm, Hh^Efm, Hh, Re, Re^Vhc, Gs, Hh
Gg, Hh, Gs^Fds, Hh, Rb, Re, Hh, Rb, Re, Gs, Rb, Gs, Re, Rb, Gg^Efm, Wwrg, Wwg, Gg, Wo^Wkf, Wo, Wwrg, Gg^Fds, Gg^Fds, Ss, Wo, Ss, Gg, Rb, Gs^Fds, Re, Rb, Rb, Gs^Fds, Gs, Gs^Fds, Gs^Fds
Gg, Hh^Efm, Gs^Fds, Rb^Vhc, Gs, Gs^Efm, Gs^Qhu, Gg^Fds, Gs^Es, Re, Rb^Vhc, Rb, Gg^Fds, Gg^Es, Gg^Fds, Wo, Gg^Qhh, Wwrg, Wwg^Ewf, Wwg, Gg, Wwg, Wwrg, Wwg, Wo^Wkf, Wo^Ewf, Gs^Fds, Rb^Vhc, Gs, Gs^Es, Gs^Fds, Gs, Gs, Gs^Fds, Gs^Fds, Gs^Fds
Gs^Fds, Gg, Hh^Fds, Gs^Fds, Gs^Fds, Gs^Qhu, Hh^Fds, Gs^Qhu, Gs^Fds, Gs, Gg^Fds, Rb, Re, Gs^Efm, Re, Gg, Hh, Gg^Qhh, Gg^Es, Gg, Gg, Wwg, Gg^Efm, Wwg, Wwg, Wo^Wkf, Wo, Gs^Fds, Gg, Gs, Gs, Gs, Ket, Ce, Ce, Gs
Gg, Hh, Gs^Fds, Gs^Efm, Gs^Efm, Gs^Es, Hh^Fds, Gs, Gs^Fds, Gs^Fds, Gs^Fds, Gs, Rb, Rb, Hh, Rb, Re, Hh, Rb, Gs^Efm, Hh, Gg^Es, Gs, Gg, Gg^Fds, Wwg^Ewl, Wo, Wwg, Gg^Fds, Gg^Efm, Gs^Fds, Ce, Ce, Ce, Ce, Gs
Gs^Fds, Gs^Fds, Gs, Gs^Fds, Gs, Gs^Fds, Gs^Fds, Gs^Fds, Hh, Gs, Gs^Efm, Rb, Gg^Fds, Hh^Es, Gs, Gs, Gs^Efm, Rb, Gs^Fds, Rb, Re, Hh, Rb^Efm, Gs^Fds, Rb^Vhc, Gg^Fds, Wwrg, Ss, Gg^Fds, Gs, Gs^Fds, Ce, Ce, Ce, Gs^Fds, Gs
Gs, Gs, Ce, Ce, Ket, Gs^Fds, Gs^Fds, Hh^Fds, Gs^Fds, Gs, Re, Rb, Gs^Es, Gs, Hh, Gs, Gs, Gs, Ce, Ce, Gs, Rb, Gs, Re, Gs^Fds, Gg, Wwg, Wwg, Gg^Fds, Gs^Fds, Gs^Fds, Gs^Fds, Gs, Gs, Gs^Fds, Gs^Fds
Gs, Ce, Ce, Ce, Ce, Ce, Gs, Gs^Fds, Gs^Fds, Gs^Fds, Re, Gs, Gs^Fds, Gg^Fds, Gs^Qhh, Gs, Ce, Ket, Ce, Ce, Gs^Es, Gs^Efm, Hh^Fds, Hh^Fds, Gs^Fds, Ss, Wo, Wo^Wkf, Wwrg, Gg, Gg^Fds, Gs^Fds, Gs^Fds, Gs^Efm, Gs, Gs
Hh, Gs^Efm, Gs, Ce, Gs, Gs^Fds, Gs^Fds, Gs, Gs^Fds, Gs^Fds, Rb, Gs^Fds, Gs^Vhc, Gs^Qhh, Gs^Qhh, Gs, Gs, Ce, Ce, Ce, Gs^Fds, Gs^Fds, Gs^Es, Hh^Efm, Gs, Gs^Fds, Gg, Gg^Fds, Wo, Wwg, Gg^Fds, Gs, Gs^Fds, Gs^Es, Hh, Hh
Hh, Hh, Gs, Gs, Gs^Efm, Gs, Gs, Gs, Gs, Gs, Gs, Re, Gs^Fds, Gs^Efm, Gs, Hh, Hh, Gs, Gs, Gs, Gs, Gs, Gs^Fds, Gs, Hh, Gs^Efm, Gs, Wo^Wkf, Wo, Wo^Ewl, Gs, Gs, Gs, Gs, Gs, Gs
