Aa, Aa, Aa^Es, Aa, Ha, Gd, Aa^Edp, Aa, Aa^Es, Aa, Ha, Aa, Aa^Qhh, Aa^Qhh, Ha^Qhh, Ha, Aa^Es, Aa, Aa^Qhh, Aa^Qhh, Aa^Qhh, Aa^Qhh, Ha^Qhh, Gd^Qhh, Ha, Gd, Ha, Aa, Aa, Aa, Ha, Ha, Ha, Ha
Aa^Fma, Aa, Aa, Aa^Es, Aa, Ha^Es, Aa^Edp, Aa, Aa, Ha^Es, Ha^Es, Aa, Aa, Aa, Aa^Es, Ha^Es, Aa^Es, Aa^Fma, Aa, Aa^Qhh, Aa^Qhh, Aa^Qhh, Ha^Qhh, Ha^Qhh, Ha^Qhh, Ha^Es, Ha^Es, Aa, Aa^Es, Rb, Aa^Es, Ha, Ha, Ha
Aa, Aa^Fma, Aa, Aa^Fma, Aa, Aa^Es, Aa^Es, Aa^Fma, Aa, Aa^Em, Aa, Aa, Aa, Aa^Es, Aa, Ha, Aa, Aa^Es, Aa^Es, Aa, Aa, Aa^Edp, Aa^Qhh, Ha^Qhh, Aa^Qhh, Aa, Aa^Es, Aa^Es, Aa^Edp, Rb, Aa^Es, Aa, Ha^Qhh, Aa^Qhh
Aa, Aa^Fma, Aa^Fma, Aa^Efm, Aa, Aa^Voa, Aa^Fma, Aa, Aa, Aa, Aa, Aa^Fma, Aa, Aa^Efm, Aa, Aa^Es, Aa, Aa, Aa, Aa, Re^Voa, Aa, Aa, Aa^Qhh, Aa^Qhh, Aa^Edp, Aa^Edp, Aa, Aa, Rb, Aa^Edp, Ha^Es, Aa, Aa
Ai, Aa, Ai, Ai, Ai, Aa^Fma, Aa, Aa^Efm, Aa^Es, Aa^Fma, Aa^Es, Aa, Aa^Fma, Aa^Fma, Aa^Fma, Aa, Aa, Aa^Fma, Aa, Aa, Aa, Aa, Aa, Aa, Aa, Aa, Aa^Edp, Aa^Edp, Rb, Aa, Aa^Qhh, Aa, Aa^Qhh, Aa
Ai, Ai, Ai, Ai, Ai, Ai, Ai, Aa, Ai, Ai, Aa, Aa^Efm, Aa^Fma, Aa^Fma, Aa^Fma, Aa, Aa, Aa, Aa^Fma, Aa^Efm, Aa, Aa^Fma, Aa, Aa, Aa^Fma, Aa, Aa, Aa, Rb, Aa, Aa^Qhh, Aa^Qhh, Aa^Qhh, Aa^Qhh
Ai, Ai, Ai, Ai, Ai, Ai, Ai, Ai, Ai, Ai, Ai, Aa^Fma, Aa, Aa, Ai, Aa^Fma, Ai, Aa, Aa, Aa^Fma, Aa, Aa^Es, Aa, Aa, Aa, Aa^Es, Aa^Es, Aa, Aa, Aa^Es, Aa^Es, Aa^Qhh, Ha^Qhh, Ha^Qhh
Ai, Ai, Ai, Ai, Ai, Ai, Ai, Ai, Ai, Ai, Ai, Ai, Ai, Ai, Ai, Ai, Ai, Ai, Ai, Ai, Aa, Aa^Es, Aa^Es, Aa^Fma, Aa^Efm, Aa, Aa^Fma, Rb, Aa, Aa, Ha^Es, Ha^Qhh, Aa, Ha^Qhh
Ai, Ai, Ai, Aa, Aa, Ai, Aa^Es, Ai, Ai, Ai, Ai, Ai, Ai, Ai, Ai, Ai, Ai, Ai, Ai, Ai, Ai, Aa^Fma, Aa^Fma, Aa, Aa, Aa^Fma, Aa, Rb, Rb, Aa^Es, Ha^Es, Ha, Ha^Qhh, Ha
Ai, Ai, Ai, Ai, Aa^Fma, Aa, Re^Voa, Aa^Fma, Aa, Aa, Aa, Ai, Aa^Edb, Aa^Fma, Aa, Aa, Aa, Ai, Ai, Ai, Ai, Ai, Ai, Aa, Ai, Aa^Fma, Aa, Aa, Aa^Fma, Aa, Aa^Es, Ha^Es, Ha, Aa
Ai, Ai, Ai, Ai, Aa^Wkf, Aa, Aa^Fma, Aa^Es, Aa^Es, Aa^Fma, Ha, Aa, Aa^Dr, Aa^Edb, Coa^Edb, Aa, Aa^Es, Aa^Fma, Ai, Ai, Aa, Ai, Ai, Ai, Ai, Ai, Ai, Aa, Aa, Rb^Es, Aa, Ha, Aa, Ha
Ai, Ai, Ai, Ai, Ai, Aa^Wkf, Aa, Aa^Fma, Aa, Ha^Es, Ha, Aa^Dr, Coa^Es, Coa^Es, Aa, Coa^Es, Coa^Es, Aa^Fma, Aa, Ai, Aa, Aa, Ai, Ai, Ai, Ai, Ai, Aa^Fma, Aa^Efm, Rp, Aa^Fma, Aa, Aa, Aa^Fma
Ai, Ai, Ai, Ai, Ai, Ai, Aa, Aa^Es, Aa, Ha, Aa^Es, Coa, Koa^Es, Koa^Es, Koa^Es, Aa, Aa^Es, Coa, Coa^Es, Coa^Es, Coa, Aa, Aa, Ai, Ai, Ai, Ai, Re^Ecf, Rp, Aa, Aa^Voa, Aa, Aa, Aa
Aa, Ai, Ai, Ai, Ai, Ai, Ai, Aa^Wkf, Aa, Aa, Coa^Es, Aa, Aa, Koa^Es, Aa, Aa, Aa^Es, Aa, Aa^Es, Aa^Voa, Aa^Es, Coa, Coa, Aa^Wkf, Ai, Ai, Ai^Bsa/, Rp, Aa, Re^Ecf, Aa, Aa, Aa^Fma, Aa
Aa^Fma, Ai, Aa, Ai, Ai, Ai, Ai, Ai, Aa^Fma, Aa, Coa, Aa^Es, Aa^Es, Aa^Es, Aa, Aa, Aa, Aa, Aa, Aa^Es, Aa^Es, Aa^Voa, Aa, Koa, Aa^Pr\, Ai^Bsa/, Ai, Ai, Ai, Aa, Aa, Aa^Efm, Aa, Aa^Fma
Aa, Aa, Aa, Aa, Ai, Ai, Ai, Ai, Aa, Aa, Aa, Coa, Coa, Aa^Voa, Aa^Voa, Aa^Es, Aa, Aa^Es, Aa, Aa, Aa, Aa, Aa^Es, Aa, Coa^Es, Koa, Ai, Ai, Ai, Aa^Fma, Aa, Aa^Fma, Aa^Fma, Aa
Aa, Aa^Fma, Aa, Aa^Fma, Aa, Ai, Ai, Ai, Ai, Aa, Aa, Aa, Ai, Coa, Aa, Aa, Aa, Aa^Es, Coa, Coa, Coa, Aa^Es, Coa^Es, Coa^Es, Ha^Dr, Aa^Dr, Aa^Fma, Ai, Ai, Aa, Aa^Fma, Aa, Aa, Aa
Aa, Aa^Em, Aa^Es, Aa^Efm, Aa, Ai, Ai, Ai, Ai, Ai, Ai, Ai, Ai, Koa, Aa^Pr\, Aa, Coa, Coa^Es, Aa, Aa^Es, Aa^Es, Aa^Es, Aa, Ha^Es, Ha^Edb, Aa^Edb, Aa^Fma, Aa, Ai, Ai, Aa, Aa^Fma, Aa, Aa
Aa, Aa, Aa^Fma, Aa^Fma, Aa^Es, Aa, Aa, Ai, Ai, Ai, Ai, Ai, Ai^Bsa/, Ai^Bsa/, Ai, Koa, Ai, Aa, Aa, Aa, Aa, Aa, Aa^Es, Aa^Es, Aa, Aa^Fma, Aa, Aa, Ai, Ai, Ai, Ai, Ai, Ai
Aa^Fma, Aa, Aa, Aa^Fma, Aa, Aa^Efm, Aa^Fma, Ai, Ai, Ai, Ai^Bsa/, Ai^Bsa/, Ai, Ai, Ai, Ai, Ai, Aa, Aa^Fma, Aa^Fma, Aa^Fma, Ai, Ai, Ai, Ai, Aa, Aa, Aa^Es, Aa^Fma, Ai, Aa^Es, Ai, Ai, Ai
Ha, Aa, Aa, Aa^Es, Aa, Aa^Fma, Aa^Fma, Re^Ecf, Rb, Rb, Aa^Fma, Ai, Aa, Ai, Ai, Ai, Ai, Ai, Ai, Aa, Ai, Aa, Aa, Aa, Ai, Ai, Aa, Aa^Voa, Ai, Aa, Aa^Fma, Aa, Ai, Ai
Ha, Ha^Es, Aa^Es, Aa^Fma, Aa, Aa, Aa^Es, Aa^Voa, Rb, Re^Ecf, Aa^Es, Aa, Aa^Fma, Ai, Ai, Ai, Ai, Ai, Ai, Ai, Ai, Ai, Ai, Ai, Ai, Ai, Ai, Aa, Aa, Ai, Aa, Aa, Ai, Ai
Ha, Aa, Ha^Fma, Aa^Es, Aa, Aa^Es, Aa, Aa, Rb, Aa, Aa^Fma, Aa, Aa, Aa, Aa, Ai, Aa^Fma, Ai, Aa, Ai, Ai, Ai, Ai, Ai, Ai, Ai, Ai, Ai^Bw/, Ai, Ai, Ai, Ai, Ai, Ai
Ms, Ha, Ha^Es, Aa, Aa, Aa^Fma, Aa, Aa, Aa, Aa, Aa, Aa^Fma, Aa, Aa, Aa^Fma, Aa^Efm, Aa, Aa^Voa, Aa^Fma, Aa, Ai, Ai, Ai, Ai, Ai, Ai, Ai, Ai, Ai, Ai, Ai, Ai, Ai, Ai
Ms, Ms, Ha^Es, Aa^Es, Aa^Es, Aa, Aa, Rb, Aa, Aa, Aa^Fma, Aa, Aa, Aa, Aa, Aa, Aa^Fma, Aa^Fma, Aa^Es, Aa, Aa^Fma, Aa, Aa, Aa, Aa^Fma, Ai, Ai, Ai, Ai, Ai, Ai, Ai, Ai, Ai
Ha, Ha^Dr, Aa, Aa^Es, Aa, Aa, Rb, Rb, Ha, Aa, Aa, Aa, Aa^Es, Aa^Es, Aa^Fma, Aa, Aa^Fma, Aa, Aa^Es, Aa, Aa^Es, Aa, Aa, Aa^Fma, Aa, Aa^Fma, Aa, Aa, Ai, Ai, Ai, Ai, Ai, Ai
Ha, Ha, Rb, Rb, Aa, Rb, Aa, Ha, Aa, Aa, Aa^Fma, Aa, Aa^Es, Aa^Es, Aa^Es, Aa, Aa^Efm, Aa, Aa^Em, Aa^Fma, Aa^Es, Aa^Fma, Aa^Efm, Aa, Aa^Fma, Aa, Aa, Aa^Fma, Aa^Efm, Aa, Aa^Fma, Ai, Aa, Ai
Aa^Dr, Aa^Dr, Rb, Aa, Aa^Edp, Aa, Ha^Es, Ha, Aa, Aa^Es, Aa, Aa, Aa^Voa, Aa, Aa, Aa, Aa, Aa, Aa, Aa, Aa, Aa^Es, Aa, Aa, Aa, Aa^Es, Aa^Es, Aa, Aa, Aa^Voa, Aa, Aa^Fma, Aa, Ai
Aa, Aa^Em, Aa, Aa^Es, Ha^Es, Ha, Ha^Es, Aa^Es, Aa^Qhh, Aa, Aa, Aa, Aa, Aa, Aa, Aa^Es, Aa^Es, Aa^Fma, Aa, Ha, Aa, Aa^Fma, Aa^Fma, Aa, Aa, Aa, Aa, Aa, Aa^Fma, Aa, Aa^Fma, Aa, Aa^Fma, Aa
Aa^Edp, Aa, Rb, Aa, Ha, Ha^Es, Ha^Qhh, Aa, Aa^Qhh, Aa, Aa, Aa^Fma, Aa, Aa^Qhh, Aa^Qhh, Aa, Aa, Ha^Es, Ha^Es, Ha^Es, Ha, Aa, Aa, Aa, Aa, Aa^Fma, Aa, Aa, Aa, Aa^Efm, Aa, Aa, Aa, Aa
Aa^Edp, Aa^Edp, Rb, Aa, Aa, Ha, Ha^Qhh, Ha^Qhh, Aa^Qhh, Aa, Aa^Qhh, Aa, Aa, Aa^Qhh, Aa^Qhh, Aa, Aa^Es, Ha^Es, Aa, Ha, Ha, Aa, Aa^Es, Aa, Aa^Fma, Aa^Fma, Aa^Es, Aa^Es, Ha^Es, Aa, Aa^Fma, Aa, Aa^Fma, Aa
Rb, Rb, Aa, Aa^Es, Aa, Ha^Qhh, Aa^Dr, Ha^Qhh, Aa^Dr, Aa^Qhh, Aa^Qhh, Aa, Aa^Edp, Aa^Edp, Aa^Edp, Aa, Aa^Es, Aa^Es, Aa^Qhh, Aa, Aa^Voa, Aa^Es, Aa, Aa, Aa, Aa, Aa^Es, Aa^Em, Ha^Edp, Aa, Aa, Aa, Aa, Aa
Aa, Aa^Voa, Aa^Es, Aa^Qhh, Aa^Qhh, Ha^Qhh, Ms^Qhh, Ha^Qhh, Ha^Qhh, Aa^Qhh, Aa^Dr, Aa^Qhh, Aa^Qhh, Aa^Edp, Aa^Qhh, Aa^Edp, Aa, Aa, Aa^Qhh, Aa^Qhh, Aa, Ha^Es, Ha^Es, Ha, Aa^Edp, Ha, Ha^Es, Ha^Es, Ha^Es, Aa, Ha, Aa, Aa, Aa
Aa, Aa, Aa, Aa^Qhh, Aa^Qhh, Ms^Qhh, Ms^Qhh, Ms^Qhh, Ms^Qhh, Ha^Qhh, Aa^Dr, Aa^Qhh, Aa^Qhh, Aa^Edp, Aa^Qhh, Aa^Qhh, Aa^Qhh, Aa^Qhh, Aa^Qhh, Aa^Qhh, Aa^Qhh, Ha^Es, Aa, Ha^Es, Ha^Edp, Aa^Dr, Ms, Ms, Ms, Aa^Dr, Aa, Aa, Ha, Aa
Aa, Aa^Em, Aa, Aa^Qhh, Aa^Qhh, Ha^Qhh, Ha^Qhh, Ms^Qhh, Ha^Qhh, Ha^Qhh, Aa, Aa^Qhh, Aa, Aa^Qhh, Aa^Qhh, Aa^Qhh, Aa, Aa^Qhh, Aa, Aa^Qhh, Aa^Qhh, Aa, Aa, Aa^Es, Gd, Ms, Ms, Ms, Ms, Aa^Dr, Ms, Aa, Aa, Ha
