Gd, Gd, Gs^Es, Gs, Hhd, Gd, Gd^Edp, Gd, Gd^Es, Gd, Hhd, Gd, Gd^Qhh, Gd^Qhh, Hhd^Qhh, Hhd, Gd^Es, Gd, Gd^Qhh, Gd^Qhh, Gd^Qhh, Gd^Qhh, Hhd^Qhh, Gd^Qhh, Hhd, Gd, Hhd, Gd, Rb, Gd, Hhd, Gd, Hhd, Gd
Gd^Fmw, Gd, Gd, Gd^Es, Gs, Hhd^Es, Gs^Edp, Gs, Gd, Hhd^Es, Hhd^Es, Gs, Gs, Gd, Gd^Es, Hhd^Es, Gd^Es, Gs^Fmw, Gd, Gd^Qhh, Gd^Qhh, Gd^Qhh, Hhd^Qhh, Hhd^Qhh, Hhd^Qhh, Hhd^Es, Hhd^Es, Gd, Gd^Es, Rb, Gd^Es, Hhd, Hhd, Hhd
Gg, Gd^Fmw, Gd, Gd^Fmw, Gd^Gvs, Gs^Es, Re^Es, Gd^Fmw, Gd, Gs^Em, Gd, Gd, Gd, Gd^Es, Gd, Hhd, Gd, Gd^Es, Gd^Es, Gd, Gd, Gd^Edp, Gd^Qhh, Hhd^Qhh, Gd^Qhh, Gd, Gd^Es, Gd^Es, Gd^Edp, Rb, Gd^Es, Gd, Hhd^Qhh, Gd^Qhh
Ss, Gg^Fmw, Gg^Fmw, Gg^Efm, Dd, Re^Vo, Gd^Fmw, Re, Re, Re, Re, Gd^Fmw, Re, Re^Efm, Re, Gs^Es, Re, Re, Re, Re, Re^Vo, Gd, Gd, Gd^Qhh, Gd^Qhh, Gd^Edp, Gd^Edp, Gd, Rb, Rb, Gd^Edp, Hhd^Es, Gd, Gd
Wwt^Wkf, Ss, Wwt^Wkf, Wwt^Ewl, Wwrt^Es, Gg^Fmw, Sm, Gg^Efm, Gg^Es, Gg^Fmw, Gg^Es, Re, Gs^Fmw, Gd^Fmw, Gd^Fmw, Re, Gd, Gd^Fmw, Gd, Gs^Gvs, Gd^Gvs, Re, Re, Gd, Re, Gd, Gd^Edp, Gd^Edp, Rb, Gd, Gd^Qhh, Gd, Gd^Qhh, Gd
Wwt, Wwrt^Wkf, Wot, Wwt^Es, Wwt^Ewf, Wwt^Wkf, Wwt^Wkf, Ss, Wwrt^Es, Wwrt^Es, Dd, Gd^Efm, Gd^Fmw, Gd^Fmw, Gg^Fmw, Gd, Sm, Gd, Gg^Fmw, Gd^Efm, Gd, Gs^Fmw, Gs, Re, Gd^Fmw, Re, Re, Gd, Rb, Gd, Gd^Qhh, Gd^Qhh, Gd^Qhh, Gd^Qhh
Wot^Wkf, Wot, Wot^Wkf, Wot, Wot, Wot, Wwt, Wwt, Wot^Es, Wwt^Wkf, Wwt^Ewf, Gg^Fmw, Dd, Dd, Wwt^Wkf, Gg^Fmw, Wwt^Es, Sm, Ss, Gg^Fmw, Gg, Gs^Es, Gs, Gd, Gd, Gs^Es, Gs^Es, Re, Gd, Gd^Es, Gd^Es, Gd^Qhh, Hhd^Qhh, Hhd^Qhh
Wot, Wot, Wwt, Wwt^Ewf, Wwt^Wkf, Wot, Wwrt, Wot, Wwt, Wot, Wot, Wwt, Wwt, Wwt^Ewl, Wot, Wwt, Wot, Wwrt^Es, Wwt^Es, Wwrt^Wkf, Dd, Gd^Es, Gd^Es, Gs^Fmw, Gs^Efm, Gd, Gs^Fmw, Rb, Gd, Gs, Hhd^Es, Hhd^Qhh, Gd, Hhd^Qhh
Wot, Wot, Wwt^Ewl, Sm, Sm^Wkf, Wwrt, Gg^Es, Wwt^Wkf, Wwt^Wkf, Wwrt^Es, Wwrt, Wot, Wot^Wkf, Wot^Es, Wwrt^Es, Wot^Ewf, Wwt^Es, Wot, Wot, Wwt, Wwt^Wkf, Gg^Fmw, Gg^Fmw, Gg, Sm, Gd^Fmw, Gd, Rb, Rb, Gd^Es, Hhd^Es, Hhd, Hhd^Qhh, Hhd
Wot, Wot, Wwt, Wwt^Wkf, Gg^Fmw, Gg^Gvs, Re^Vo, Gg^Fmw, Gg, Sm, Dd, Wwt^Ewl, Gg^Edb, Gg^Fmw, Gg, Sm^Wkf, Dd, Wwrt^Es, Wot^Es, Wot, Wot, Wwt^Wkf, Wwt^Ewf, Ss, Wwt^Wkf, Gg^Fmw, Dd, Gd, Gd^Fmw, Rp, Gd^Es, Hhd^Es, Hhd, Gd
Wot, Wot, Wot, Wwt^Wkf, Dd^Wkf, Gs^Gvs, Gs^Fmw, Re^Es, Re^Es, Gd^Fmw, Hhd, Dd, Gd^Dr, Gd^Edb, Co^Edb, Gd, Gd^Es, Gg^Fmw, Wwt^Wkf, Wot^Ewl, Gg, Wot, Wot, Wot^Ewl, Wot, Wwrt^Es, Wwt^Es, Dd, Gd, Rb^Es, Gs, Hhd, Gd, Hhd
Wot^Wkf, Wot, Wot, Wwrt, Wwt^Ewf, Dd^Wkf, Gg, Gd^Fmw, Re, Hhd^Es, Hhd, Hhd^Dr, Co^Es, Co^Es, Rb, Co^Es, Co^Es, Gg^Fmw, Gg, Wwt^Ewf, Gg^Gvs, Dd, Wwrt^Wkf, Wot, Wot, Wot, Wwt^Wkf, Gg^Fmw, Gd^Efm, Rp, Gs^Fmw, Gs, Gs, Gd^Fmw
Wwt^Ewl, Wot^Ewf, Wot^Wkf, Wot, Wot, Wwt^Ewl, Ss, Gg^Es, Re, Hhd, Rb^Es, Co, Ko^Es, Ko^Es, Ko^Es, Rb, Rb^Es, Co, Co^Es, Co^Es, Co, Gg^Gvs, Sm, Wwrt^Es, Wwt^Es, Wot, Wwt^Ewf, Gg^Ecf, Rp, Rb, Re^Vo, Gs, Gd, Gd
Sm^Wkf, Wwt^Es, Wwt^Es, Wot, Wot, Wwt, Wwrt, Sm^Wkf, Gg^Gvs, Re, Co^Es, Rb, Rb, Ko^Es, Rp, Rb, Rp^Es, Rp, Rb^Es, Rb^Vo, Rb^Es, Co, Co, Gg^Wkf, Wwt^Ewf, Wot, Wot^Bsb/, Rp, Dd, Gs^Ecf, Gs, Gd, Gs^Fmw, Gd
Gg^Fmw, Wwrt^Es, Sm^Wkf, Wwt, Wwt, Wot, Wwt, Wwrt^Wkf, Gg^Fmw, Gd^Gvs, Co, Rb^Es, Rb^Es, Rp^Es, Rb, Rp, Rb, Rp, Rb, Rb^Es, Rb^Es, Rb^Vo, Rb, Ko, Rr^Pr\, Wwt^Bsb/, Wwt^Ewl, Wot, Wwrt^Wkf, Dd, Gd, Gd^Efm, Gd, Gd^Fmw
Gd, Sm^Wkf, Sm, Ss^Wkf, Wwrt^Es, Wot, Wot, Wwrt, Dd, Gg, Ss, Co, Co, Rb^Vo, Rb^Vo, Rp^Es, Rp, Rb^Es, Rb, Rb, Rb, Rb, Rb^Es, Rb, Co^Es, Ko, Wwt^Wkf, Wot, Wwt^Wkf, Gg^Fmw, Sm, Gd^Fmw, Gs^Fmw, Gd
Gd, Gd^Fmw, Gd, Gg^Fmw, Dd^Wkf, Wwt^Es, Wot^Ewf, Wwt, Wwt, Sm, Gg, Ss, Wwt^Ewf, Co, Rb, Rb, Rb, Rb^Es, Co, Co, Co, Rb^Es, Co^Es, Co^Es, Hhd^Dr, Gg^Dr, Gg^Fmw, Wot^Ewl, Wot, Ss, Gg^Fmw, Gd, Gd, Gd
Gs, Gs^Em, Gd^Es, Gg^Efm, Dd, Wwt^Wkf, Wwt^Ewl, Wot, Wot, Wwt, Wwt, Wwt^Ewl, Wwt, Ko, Rr^Pr\, Rb, Co, Co^Es, Gs^Gvs, Gs^Es, Gg^Es, Rb^Es, Re, Hhd^Es, Hhd^Edb, Gd^Edb, Gg^Fmw, Ss, Wot, Wwrt^Es, Ss, Gg^Fmw, Dd, Gg
Gd, Gd, Gs^Fmw, Gs^Fmw, Gs^Es, Gg, Sm^Wkf, Wwrt, Wot^Wkf, Wot, Wot, Wot, Wot^Bsb/, Wwt^Bsb/, Wwt, Ko, Wwt^Ewl, Gg^Gvs, Gs^Gvs, Ss, Ss, Gg, Gg^Es, Re^Es, Re, Re^Fmw, Re, Dd^Wkf, Wwt^Wkf, Wot^Es, Wot, Wwt^Wkf, Wwt, Wwt^Wkf
Gd^Fmw, Gd, Gs, Gd^Fmw, Gs, Gg^Efm, Gg^Fmw, Wwrt^Es, Wwt^Es, Wwt, Wwt^Bsb/, Wot^Bsb/, Wot, Wot, Wot, Wwt, Wwt^Ewf, Sm, Gg^Fmw, Gg^Fmw, Gg^Fmw, Wwt^Ewf, Wwt, Wwt, Wwt^Ewl, Sm, Sm, Re^Es, Gg^Fmw, Wwt^Wkf, Gg^Es, Wot, Wwt, Wwt
Hhd, Gs, Gd, Gs^Es, Gs, Gs^Fmw, Gd^Fmw, Gg^Ecf, Rp, Rp, Gg^Fmw, Wwt^Wkf, Ss, Wwt, Wot, Wot, Wot, Wwt, Wot, Sm, Wwt, Gg, Dd, Gg, Wwt, Wwt^Ewf, Dd^Wkf, Gd^Vo, Wwt^Wkf, Sm, Gs^Fmw, Dd, Wwt^Wkf, Wwt
Hhd, Hhd^Es, Gd^Es, Gd^Fmw, Gd, Gs, Gs^Es, Re^Vo, Rp, Gd^Ecf, Gd^Es, Gg, Gg^Fmw, Wwt^Wkf, Wwt^Ewf, Wwt^Wkf, Wwt, Wot, Wwt, Wot, Wot, Wwt, Wot, Wwt, Wot, Wot, Wwt, Dd, Gg, Wwt, Ss, Sm, Wwt^Wkf, Wwt^Wkf
Hhd, Gd, Hhd^Fmw, Gd^Es, Gs, Gd^Es, Gd, Gs, Rb, Gs, Gs^Fmw, Gs, Gs, Dd, Dd, Wwt^Ewl, Gg^Fmw, Wwt^Wkf, Ss, Wwt^Es, Wwrt, Wot, Wwt^Ewf, Wot, Wot, Wot, Wot, Wwt^Bw/, Wot, Wwt, Wwt^Ewf, Wwt^Ewl, Wwt, Wwt
Md, Hhd, Hhd^Es, Gs, Gd, Gs^Fmw, Gd, Gs, Rp, Gd, Gd, Gd^Fmw, Gd, Gd, Gs^Fmw, Gg^Efm, Re, Gd^Vo, Gg^Fmw, Ss, Wwrt^Es, Wwt^Es, Wwt^Wkf, Wwt^Es, Wwrt, Wot, Wwt^Es, Wot, Wot, Wot, Wot, Wot, Wot, Wot
Md, Md, Hhd^Es, Gs^Es, Gd^Es, Gs, Rp, Rb, Gs, Re, Gd^Fmw, Gs, Re, Re, Re, Re, Gs^Fmw, Gs^Fmw, Gs^Es, Gg, Gg^Fmw, Dd^Wkf, Dd^Wkf, Dd, Gg^Fmw, Wwrt^Es, Wwt^Wkf, Wwt, Wwt^Ewl, Wot, Wwt, Wot, Wot, Wot
Hhd, Hhd^Dr, Gd, Gd^Es, Gs, Gd, Rb, Gd, Hhd, Re, Re, Re, Gd^Es, Gd^Es, Gs^Fmw, Gs, Gd^Fmw, Gs, Gs^Es, Gs, Gd^Es, Gs, Gs, Gs^Fmw, Gd, Gg^Fmw, Sm, Ss^Wkf, Wwt^Wkf, Wwt, Wwt, Wwt, Wwt, Wwt
Hhd, Hhd, Rb, Rb, Rb, Rb, Gs, Hhd, Gd, Gd, Gd^Fmw, Re, Gs^Es, Gd^Es, Gs^Es, Gd, Gs^Efm, Gs, Gs^Em, Gs^Fmw, Gs^Es, Gs^Fmw, Gd^Efm, Gs, Gd^Fmw, Gs, Gd, Gg^Fmw, Gg^Efm, Dd, Gg^Fmw, Wwt, Ss, Wwt
Gd^Dr, Gs^Dr, Rb, Gd, Gd^Edp, Gd, Hhd^Es, Hhd, Gd, Gd^Es, Gd, Re, Gd^Vo, Gd, Gs, Gs, Gd, Gd, Gs, Gd, Gs, Gd^Es, Gs, Gs, Gd, Gs^Es, Gs^Es, Gd, Re, Gd^Vo, Gs^Gvs, Gg^Fmw, Gg, Wwt
Gd, Gd^Em, Rb, Gs^Es, Hhd^Es, Hhd, Hhd^Es, Gs^Es, Gd^Qhh, Gd, Gd, Gd^Gvs, Gd, Re, Re, Gd^Es, Gd^Es, Gd^Fmw, Gd, Hhd, Gs, Gs^Fmw, Gs^Fmw, Gd, Re, Re, Re, Re, Gs^Fmw, Gd, Gs^Fmw, Gd, Gd^Fmw, Gg
Gd^Edp, Gd, Rb, Gd, Hhd, Hhd^Es, Hhd^Qhh, Gs, Gd^Qhh, Gd, Gs, Gd^Fmw, Gd, Gs^Qhh, Gs^Qhh, Re, Gd, Hhd^Es, Hhd^Es, Hhd^Es, Hhd, Gd, Re, Re, Gd, Gd^Fmw, Gd, Gs, Gd, Gd^Efm, Gd, Gd, Gs, Gd
Gd^Edp, Gs^Edp, Rb, Gd, Gd, Hhd, Hhd^Qhh, Hhd^Qhh, Gd^Qhh, Gd, Gd^Qhh, Gd, Gd, Gd^Qhh, Gd^Qhh, Re, Re^Es, Hhd^Es, Re, Hhd, Hhd, Re, Gd^Es, Gs, Gd^Fmw, Gs^Fmw, Gd^Es, Gd^Es, Hhd^Es, Gd, Gs^Fmw, Gs, Gd^Fmw, Gs
Rb, Rb, Gd, Gs^Es, Gd, Hhd^Qhh, Hhd^Dr, Hhd^Qhh, Gd^Dr, Gs^Qhh, Gd^Qhh, Gd, Gd^Edp, Gd^Edp, Gd^Edp, Gd, Gd^Es, Re^Es, Gs^Qhh, Re, Gd^Vo, Re^Es, Gd, Gd, Gd, Gd, Gd^Es, Gd^Em, Hhd^Edp, Gs, Gd, Gd, Gs, Gd
Gd, Re^Vo, Gs^Es, Gd^Qhh, Gd^Qhh, Hhd^Qhh, Md^Qhh, Hhd^Qhh, Hhd^Qhh, Gd^Qhh, Hhd^Dr, Gd^Qhh, Gs^Qhh, Gd^Edp, Gd^Qhh, Gd^Edp, Gd, Gd, Gs^Qhh, Gd^Qhh, Gd, Hhd^Es, Hhd^Es, Hhd, Gd^Edp, Hhd, Hhd^Es, Hhd^Es, Hhd^Es, Gd, Hhd, Gd, Gd, Gd
Gd, Gd^Gvs, Gd, Gd^Qhh, Gd^Qhh, Md^Qhh, Md^Qhh, Md^Qhh, Md^Qhh, Hhd^Qhh, Gd^Dr, Gd^Qhh, Gd^Qhh, Gd^Edp, Gd^Qhh, Gs^Qhh, Gd^Qhh, Gd^Qhh, Gd^Qhh, Gd^Qhh, Gd^Qhh, Hhd^Es, Gd, Hhd^Es, Hhd^Edp, Gd^Dr, Md, Md^Es, Md, Gd^Dr, Gs, Gd, Hhd, Gd
Gd, Gs^Em, Gd, Gd^Qhh, Gd^Qhh, Hhd^Qhh, Gd^Qhh, Md^Qhh, Gd^Qhh, Hhd^Qhh, Gd, Gd^Qhh, Gd, Gd^Qhh, Gd^Qhh, Gd^Qhh, Gd, Gd^Qhh, Gd, Gd^Qhh, Gd^Qhh, Gd, Gd, Gd^Es, Gd, Md, Gd, Md^Es, Md, Gd^Dr, Md, Gd, Gd, Hhd
