Aa^Fma, Aa^Fma, Aa, Rra, Aa^Fma, Aa^Fma, Aa^Fma, Aa^Fma, Aa^Fpa, Aa^Fma, Ha^Fma, Ha^Fma, Ha^Fma, Ha^Fpa, Ha^Fpa, Ha^Fma, Ha^Fma, Ha^Fma, Ha^Fpa, Ha^Fma, Aa^Fma, Aa^Fma, Aa^Fma, Aa^Fma, Aa^Fma, Aa^Fma, Aa^Fma, Aa^Fma, Aa^Fma, Aa^Fda, Ww, Ww
Aa^Fma, Aa^Fma, Aa, Rra, Aa^Vea, Aa^Fma, Aa^Fda, Aa^Fma, Aa^Fma, Aa^Fma, Aa^Fda, Ha^Fma, Ha^Fpa, Ha^Fma, Ha^Fma, Ha^Fpa, Ha^Fma, Ha^Fpa, Ha^Fma, Ha^Fma, Aa^Fma, Aa^Fma, Aa^Fma, Aa^Vea, Aa^Fma, Aa^Fma, Aa^Fpa, Aa^Fma, Aa^Fda, Aa^Fda, Ww, Ww
Aa^Fma, Aa^Fma, Aa^Vea, Rra, Rra, Aa^Fma, Aa^Fma, Aa^Fpa, Aa^Fda, Aa^Fda, Aa^Fma, Aa^Fma, Aa^Fma, Aa^Fma, Aa^Fma, Ha^Fma, Aa^Fma, Ha^Fma, Aa^Fma, Aa^Fma, Aa^Fda, Aa^Fda, Aa^Fpa, Aa^Fma, Aa^Fma, Aa^Fpa, Aa^Fpa, Aa^Fma, Aa^Fda, Aa^Fda, Ww, Ww
Aa^Fma, Aa^Gvs, Aa^Gvs, Aa^Fma, Aa^Fma, Rra, Rra, Aa^Fma, Aa^Fda, Aa^Fpa, Aa^Fda, Aa^Fda, Aa^Fda, Aa^Fma, Aa^Fda, Ai, Aa^Em, Aa^Fma, Aa^Fda, Ha^Fpa, Ha^Fma, Aa^Fma, Aa^Fma, Aa^Fpa, Aa^Fda, Aa^Fma, Aa^Fma, Aa^Fma, Aa^Fma, Aa^Fda, Ww, Ww
Ha^Fma, Aa^Fma, Aa^Fma, Aa^Fma, Aa^Fma, Aa^Fma, Rra, Rra, Rra, Aa^Fma, Aa^Fpa, Aa^Fma, Aa^Fma, Aa^Fma, Aa^Fda, Aa^Fma, Aa^Fma, Aa^Fma, Aa^Fma, Ha^Fpa, Aa^Fma, Aa^Fma, Aa^Fma, Aa^Fda, Aa^Fma, Aa^Fpa, Aa^Gvs, Aa^Fma, Aa^Fma, Aa^Fda, Ww, Ww
Ms, Ha^Fma, Ms, Aa^Fpa, Aa^Fma, Aa^Fma, Aa^Fma, Aa^Fma, Aa^Fpa, Rra, Rra, Aa^Fma, Aa^Fma, Aa^Fma, Ha^Fma, Aa^Fma, Aa^Fma, Aa^Fpa, Aa^Fma, Aa^Fma, Aa^Feta, Aa^Fma, Aa^Fpa, Aa^Fma, Aa^Fma, Aa^Fma, Aa^Vea, Aa^Fma, Aa^Fda, Aa^Fda, Ww, Ww
Ms, Ms, Ms, Ha^Fma, Aa^Efm, Aa^Fma, Aa^Fma, Aa^Fma, Aa^Vea, Aa^Fma, Rra, Aa^Fma, Aa^Fma, Aa^Fda, Ha^Fda, Ha^Fda, Aa, Aa^Fpa, Ai, Aa^Fpa, Ha^Fma, Aa^Fma, Aa^Fda, Aa^Fda, Aa, Aa, Aa^Fda, Aa, Aa^Vea, Ww, Ww, Ww
Ms, Ms, Aa^Fpa, Ha^Fma, Aa^Fpa, Aa^Fma, Aa^Fma, Aa^Fma, Rra, Rra, Aa^Fma, Aa^Fma, Aa^Fpa, Aa^Fpa, Ha^Fma, Aa^Fma, Ha^Fpa, Aa^Fma, Aa^Fma, Ha^Fda, Ha^Fma, Aa^Fda, Aa^Fma, Aa^Fma, Aa, Ww, Ww, Ww, Ww, Ww, Ww, Ww
Ms, Ms, Aa^Fpa, Ha^Fma, Aa^Fda, Aa^Fda, Rra, Rra, Rra, Aa^Fma, Aa^Fpa, Aa^Fma, Aa^Fda, Aa^Fma, Aa^Fda, Ha^Fma, Aa^Fda, Aa^Fma, Aa^Fma, Aa^Fma, Aa^Fda, Aa^Fma, Aa^Fma, Aa, Ww^Bw/, Ww, Ww, Ww, Ww, Ww, Ww, Ww
Ms, Ms, Aa^Fma, Aa^Fma, Aa^Fma, Aa^Fma, Rra, Aa^Fma, Aa^Fma, Rra, Rra, Aa^Fma, Aa^Fda, Aa^Fma, Ha^Fda, Ha^Fda, Aa^Fma, Ai, Aa^Fma, Aa^Fma, Rra, Aa^Fda, Rra, Rra, Aa^Fda, Ww, Ww, Ww, Ww, Ww, Ww, Ww
Ha^Fma, Ha^Fma, Aa^Fma, Aa^Fma, Aa^Fma, Aa^Vea, Rra, Aa^Fma, Aa^Fda, Aa^Fma, Rra, Aa^Fma, Aa^Fma, Aa^Fma, Aa^Fma, Aa^Fma, Aa^Fma, Ai, Aa^Fma, Rra, Aa^Fpa, Rra, Aa^Fda, Aa^Fma, Aa^Fma, Aa^Fda, Ww, Ww, Ww, Ww, Ww, Ww
Ha^Fma, Ha^Fma, Aa^Fda, Aa^Fda, Aa^Fda, Aa^Fma, Rra, Aa^Fma, Aa^Fda, Aa^Fda, Aa^Fma, Rra, Rra, Aa^Fda, Rra, Aa^Fma, Aa^Fda, Aa^Fma, Rra, Rra, Aa^Fma, Aa^Fda, Aa^Fpa, Aa^Fma, Aa^Fda, Aa^Fda, Ww, Aa^Fda, Aa^Fma, Ds, Aa^Fda, Aa^Fda
Aa^Fma, Aa^Fma, Aa^Fma, Aa^Fma, Aa^Fma, Aa^Fpa, Rra, Aa^Fma, Aa^Fda, Aa^Fda, Aa^Fma, Aa^Fma, Aa^Fma, Rra, Aa^Fma, Rra, Rra, Rra, Aa^Fda, Aa^Fpa, Aa^Fma, Aa^Fma, Aa^Fma, Aa^Fma, Aa^Fda, Ww, Ww, Aa^Fda, Aa^Fma, Aa^Fma, Aa^Fma, Aa^Fma
Aa^Fma, Aa^Fma, Aa^Fma, Aa^Vea, Rra, Rra, Aa^Fma, Aa^Fma, Aa^Fpa, Aa^Fda, Ha^Fpa, Aa^Fma, Aa^Fma, Aa^Fpa, Aa^Fma, Rra, Aa^Fma, Aa^Fma, Aa^Fda, Aa^Fma, Aa^Fma, Aa^Fpa, Aa^Fma, Ha^Fda, Ww, Ww, Aa^Fda, Aa^Fda, Aa^Fma, Aa^Fda, Aa^Fda, Aa^Fda
Aa^Fma, Aa^Fma, Aa^Fpa, Aa^Fma, Cva, Aa^Fda, Cva, Aa^Fpa, Aa^Fma, Aa^Fma, Ha^Fpa, Ha^Fpa, Ha^Fpa, Aa^Fda, Aa^Fma, Rra, Cva, Aa^Fda, Cva, Aa^Fma, Aa^Fma, Aa^Fpa, Ha^Fda, Ha^Fma, Ha^Fda, Aa^Fda, Aa^Fma, Aa^Fma, Aa^Fda, Wwr, Ww, Ww
Aa^Fma, Aa^Fma, Aa^Fma, Cva, Cva, Kva, Cva, Cva, Aa^Fda, Aa^Fma, Ha^Fpa, Ha^Fma, Ha^Fpa, Aa^Fma, Aa^Fma, Aa^Fpa, Kva, Cva, Kva, Aa^Fpa, Aa^Fma, Aa^Fpa, Aa^Fma, Ha^Fma, Aa^Fma, Aa^Fma, Aa^Fma, Aa^Fma, Ww, Wwr, Ww, Ww
Aa^Fma, Aa^Fma, Rra^Vea, Aa^Fma, Cva, Aa^Fda, Cva, Aa^Fma, Aa^Fma, Ha^Fpa, Ha^Fda, Ha^Fpa, Aa^Fma, Aa^Fda, Aa^Fda, Cva, Cva, Cva, Cva, Cva, Aa^Fma, Aa^Fda, Ha^Fma, Aa^Fda, Ha^Fpa, Aa^Fma, Aa^Fda, Aa^Fma, Aa^Fda, Ww, Ww, Ww
Aa^Fma, Aa^Fma, Aa^Fma, Rra, Aa^Fma, Aa^Fpa, Aa^Fda, Aa^Fma, Aa^Fma, Ha^Fpa, Aa^Fma, Ha^Fpa, Ha^Fpa, Aa^Fda, Aa^Fma, Aa^Fma, Aa^Fda, Aa^Fda, Aa^Fda, Aa^Fma, Aa^Fpa, Aa^Fma, Ha^Fpa, Ha^Fda, Ai, Aa^Fma, Aa^Fma, Aa^Fda, Aa, Ww, Ww, Ww
Ww, Ww, Ww, Rra, Ai, Aa^Fma, Wwg, Ai, Wwg, Aa^Fma, Aa^Fma, Ha^Fpa, Aa^Fma, Aa^Fma, Aa^Fma, Aa^Fma, Aa^Vea, Aa^Fma, Aa^Fma, Aa^Fda, Aa^Fma, Aa^Fma, Ha^Fpa, Ha^Fpa, Ai, Aa, Aa^Fma, Aa^Fda, Aa, Ww, Ww, Ww
Aa^Fma, Aa^Fpa, Aa^Fma, Ww^Bw|, Aa^Fma, Ai, Aa^Fma, Aa^Fda, Aa^Fma, Ai, Ai, Aa^Fma, Aa^Fma, Aa^Fda, Aa^Fda, Aa^Fda, Aa^Fda, Aa^Fma, Aa^Fma, Aa^Fma, Aa^Efm, Aa^Fda, Aa^Fma, Aa^Fma, Aa^Fma, Ai, Ai, Aa^Fma, Aa^Fda, Ww, Ww, Ww
Aa^Fma, Aa^Fma, Aa^Fma, Rra, Rra, Aa^Fda, Aa^Fma, Aa^Fda, Aa^Fma, Aa^Fda, Ai, Aa^Fda, Aa^Fma, Aa^Fpa, Aa^Fma, Aa^Fma, Aa^Fda, Aa^Fpa, Aa^Fda, Aa^Fma, Aa^Fma, Aa^Fma, Aa^Fda, Aa^Fma, Aa^Fma, Aa, Ai, Aa^Fma, Aa, Aa^Fda, Ww, Ww
Aa^Fma, Aa^Fma, Aa^Fma, Aa^Fma, Rra, Aa^Fma, Aa^Fda, Aa^Fma, Aa^Fda, Aa^Fma, Aa^Fma, Ai, Ai, Ai, Ai, Aa^Fda, Aa^Fma, Aa^Fma, Aa^Fma, Aa^Fma, Aa^Fma, Ha^Fma, Ha^Fda, Aa^Fma, Ha^Fpa, Aa^Fma, Aa, Ai^Bw/, Ai, Aa^Fda, Ww, Ww
Aa^Fpa, Aa^Fma, Aa^Fma, Aa^Fda, Rra, Aa^Vea, Aa^Fma, Aa^Fma, Aa^Fma, Aa^Fma, Aa^Fma, Aa^Fda, Aa^Fma, Aa^Fda, Aa^Fma, Ai, Aa^Fda, Aa^Fma, Aa^Feta, Aa^Fma, Aa^Fma, Ha^Fpa, Ai, Ai, Ha^Fpa, Aa^Fma, Aa, Aa^Fma, Aa^Fda, Ai, Ww, Ww
Aa^Fma, Aa^Fma, Aa^Fda, Aa^Fma, Aa^Fma, Rra, Rra, Aa^Fpa, Aa^Fma, Aa^Fpa, Aa^Fda, Aa^Fma, Aa^Fma, Aa^Fma, Aa^Fda, Ai, Aa^Fma, Aa^Vea, Aa^Fma, Aa^Fma, Aa^Fda, Aa^Fma, Aa^Fma, Ha^Fda, Ha^Fpa, Aa^Fma, Aa^Fma, Aa^Fda, Ww, Ww, Ww, Ww
Aa^Fpa, Aa^Fma, Aa^Fda, Aa^Fda, Aa^Fma, Aa^Fda, Aa^Fma, Rra, Aa^Fma, Aa^Em, Aa^Fma, Aa^Fda, Aa^Fpa, Aa^Fma, Aa^Fda, Ai, Ai, Ai, Ai, Ai, Ai, Aa^Fma, Ww, Aa^Fma, Aa^Fda, Aa^Fda, Aa, Aa^Fda, Ww, Ww, Ww, Ww
Aa^Fpa, Aa^Fma, Aa^Fda, Aa^Fma, Aa^Fda, Aa^Fma, Aa^Fma, Rra, Aa^Vea, Aa^Fma, Aa^Fma, Aa^Fda, Aa^Fma, Aa^Fda, Aa^Fma, Aa^Fma, Aa^Fma, Aa^Fda, Aa^Fma, Aa^Fma, Aa^Vea, Ww, Ww, Ww, Ww, Ww, Ww^Bw|, Ww, Aa^Fda, Ww, Aa^Fda, Aa^Fda
Aa^Fma, Aa^Fma, Aa^Efm, Aa^Fma, Aa^Fma, Aa^Fda, Aa^Fma, Rra, Rra, Aa^Fma, Aa^Fma, Aa^Fda, Aa^Fda, Aa^Fma, Aa^Vea, Aa^Fma, Aa^Fma, Aa^Fma, Aa^Fma, Aa^Em, Aa^Fma, Aa^Fma, Aa^Fma, Aa^Fma, Aa^Fma, Aa^Vea, Aa, Aa^Fda, Aa^Fda, Aa^Fda, Aa^Fda, Aa^Fda
Ha^Fpa, Ha^Fma, Ha^Fma, Aa^Fma, Aa^Fda, Aa^Fda, Aa^Fma, Aa^Fma, Rra, Aa^Fma, Aa^Fda, Aa^Fda, Aa^Fma, Aa^Fma, Aa^Fma, Aa^Fma, Aa^Fma, Aa^Fma, Aa^Fma, Aa^Fma, Aa^Fda, Aa^Fpa, Aa^Fma, Aa^Fma, Aa^Fpa, Aa^Fda, Ww, Ww, Ww, Ww, Ww, Ww
Ms, Aa^Fma, Aa^Fpa, Aa^Fda, Aa^Fda, Aa^Fpa, Aa^Fpa, Aa^Fma, Aa^Fma, Rra, Rra, Aa^Fma, Rra, Rra, Rra, Rd, Rd, Rd, Rd, Aa^Fma, Aa^Fma, Aa^Fda, Rd, Re, Aa^Fda, Ww, Ww, Ww, Ww, Ww, Ww, Ww
Ms, Aa^Fpa, Ha^Fpa, Ha^Fda, Aa^Fma, Aa^Fma, Aa^Fda, Aa^Fma, Aa^Fda, Aa^Fda, Rra, Rra, Aa^Fda, Aa^Fda, Aa^Fda, Aa^Fda, Aa^Fda, Aa^Fda, Aa^Fda, Rd, Re, Rd, Aa^Fda, Aa^Fda, Ww, Ww, Ww, Ww, Ww, Ww, Ww, Ww
Ms, Ms, Ha^Fma, Aa^Fma, Ha^Fma, Aa^Fpa, Aa^Fma, Aa^Fma, Aa^Fda, Ww, Ww, Ww, Ww, Ww, Ww, Wwr, Ww, Ww, Ww, Ww, Ww, Ww, Ww, Ww, Ww, Ww, Ww, Ww, Ww, Ww, Ww, Ww
Ms, Ms, Ms, Ha^Fma, Ha^Fma, Aa^Fma, Aa^Fma, Aa^Fda, Aa^Fda, Ww, Ww, Ww, Ww, Ww, Ww, Ww, Ww, Ww, Ww, Ww, Ww, Ww, Ww, Ww, Ww, Ww, Ww, Ww, Ww, Ww, Ww, Ww
