Rp, Sm, Sm^Efm, Gg^Ftd, Sm^Ftd, Sm^Ft, Sm, Gs^Ft, Gg^Ftd, Gg, Gg^Ftd, Gg^Ftd, Hh^Ftd, Gg, Ss, Gg, Ss^Ft, Gs^Ft, Gs^Ft, Gg, Sm, Sm, Rp, Sm, Gg^Ftd, Sm, Sm, Gs^Ft, Gs^Ft, Ss, Ss, Gg
Gg, Rp, Rp, Sm, Gg^Ftd, Sm^Ftd, Ss^Ft, Gs^Ft, Ss, Gg^Ftd, Ss, Gg^Ftd, Sm, Hh^Ftd, Ss, Gs^Ft, Ss^Fts, Gs^Ft, Hh, Ss, Ss^Ftd, Sm^Efm, Rp, Gg^Vht, Gg^Ftd, Sm, Rb^Ft, Gs^Ft, Gs^Ft, Sm^Fts, Sm, Sm
Gg, Gs^Ft, Gs^Ft, Rp, Sm, Gg^Ftd, Hh, Gs^Ft, Ss^Ewf, Gg^Ftd, Ss^Ft, Gs^Ft, Ss^Ewl, Hh, Ss^Ewf, Gs^Ft, Ss^Ewf, Ss^Ewf, Hh^Fts, Hh^Ftd, Gg^Ftd, Ss^Ftd, Rp, Ss, Gg^Ftd, Rb^Ft, Rb, Ss, Ss^Ewf, Ss^Ewf, Rb^Fts, Sm
Sm, Sm^Ewf, Rb^Efm, Rp, Rp, Sm^Efm, Hh, Ss, Ss^Ewf, Gs^Ft, Gs^Ft, Ss^Ewf, Gg^Efm, Rb, Ss^Efm, Ss^Ewf, Ss^Efm, Sm, Gs^Ft, Hh^Ftd, Ss, Rp, Ss, Ss, Ss, Gg^Ftd, Hh^Ftd, Ss^Ewf, Ss^Ewf, Gs^Ft, Sm^Ft, Sm
Wot^Ewf, Wwt^Ewf, Sm, Ss^Ftd, Rp, Gg^Vht, Rp, Ss, Rb, Rb^Ft, Ss, Sm^Fts, Sm^Efm, Sm^Efm, Wwt^Efm, Wwt^Qhu, Wwt^Qhu, Gg^Ebn, Ss, Gs^Ft, Ss, Rp, Ss^Vhs, Hh, Hh, Hh^Ftd, Hh^Ftd, Hh^Fts, Ss^Ewf, Sm, Sm, Sm
Wot, Wwt^Ewl, Ss, Ss, Ss^Ft, Rp, Gs^Ft, Rp, Rp, Gg^Ftd, Gg, Sm, Sm^Efm, Sm, Wwt^Qhu, Wot^Qhu, Wwt^Qhu, Wwt^Efm, Sm^Efm, Ss, Rb, Rp, Rp, Hh, Hh^Ftd, Hh^Ftd, Gg^Ftd, Gg^Ftd, Ss^Ewf, Gs^Ft, Sm^Efm, Sm
Wot, Wot^Wkf, Wot^Wkf, Rb, Ss, Gs^Ft, Ss^Ftd, Rb^Ftd, Rp, Rb^Ftd, Rb, Rb^Ft, Rb^Efm, Wwt^Efm, Wwt^Qhu, Wot^Qhu, Wwt^Efm, Gg^Efm, Gg, Rb, Rb, Ss, Rp, Gg^Ftd, Hh, Hh^Fts, Sm, Ss, Ss, Gs^Ft, Sm^Efm, Sm
Wot, Wot, Wwrt, Sm, Sm, Ds, Rb^Fts, Rb^Ftd, Rb, Rp, Rp, Ss, Gg^Efm, Gg^Ebn, Sm^Efm, Wwt^Qhu, Gg^Efm, Ss, Ss, Gs^Fts, Gs^Ft, Ss, Rp, Rb, Ss, Hh^Fts, Sm, Gs^Ft, Gs^Ft, Ss^Fts, Gs^Ft, Gg
Ss, Wot, Wwrt, Wwrt, Wwt, Wwt, Wwt^Ewl, Sm^Ewf, Sm^Fts, Gs^Ft, Ss, Rp, Ss, Gs^Ft, Gs^Fts, Rb^Efm, Rb, Gg^Vht, Ss, Ss^Fts, Gg^Ftd, Rb, Rp, Rb, Ss, Ss, Sm^Efm, Gs^Ftd, Ss, Gs^Ft, Gg, Gg
Sm, Wwrt, Wwrt, Wwrt, Wot, Wot^Wkf, Wot^Ewl, Wwt^Wkf, Rb, Gs^Ft, Ss, Rp, Rb^Ftd, Ss, Ss, Ss, Rb, Ss, Ss, Gs^Ft, Ss, Ss^Ftd, Rb^Ftd, Rp, Gg^Ftd, Ss, Ss, Gs^Ft, Ss, Ss, Ss, Gg
Gg, Sm, Sm^Ewf, Wwt, Wwt^Wkf, Wot, Wwt^Wkf, Wot, Ss, Ss, Gg, Rp, Rb, Rb^Ftd, Ds, Sm^Ewf, Rb, Ds, Rb, Rb, Ss, Gg^Ftd, Rb^Ftd, Rp, Sm, Gg^Ftd, Gg, Gg^Ftd, Sm^Efm, Gg^Efm, Ss, Gg
Gs^Ft, Ss^Ftd, Gg^Ftd, Rb, Rb, Sm^Ewf, Sm, Wot, Wot^Wkf, Sm^Ewf, Sm, Rp, Rb, Sm^Fts, Wwt^Wkf, Sm^Fts, Ss, Wwt^Wkf, Sm^Wkf, Sm, Sm^Efm, Sm^Ewf, Rb, Rp, Rb, Sm^Efm, Gs^Ftd, Sm, Gs^Ft, Gg^Efm, Sm, Gg
Gs^Ft, Ss, Ss^Ftd, Sm^Ftd, Rb, Ds, Wwt^Ewf, Wot^Wkf, Wot, Wwt^Wkf, Wwt^Ewl, Rp, Wot, Wwt^Ewf, Wot, Wot, Wot, 1 Wot^Ewl, Wot, Wwt^Ewf, Wwt^Ewf, Rb, Rp, Rp, Gg, Gs^Ft, Gs^Ft, Ss^Ft, Gg^Vht, Ss, Rp, Sm
Gs^Ft, Gs^Ft, Rb^Efm, Rb^Vht, Gs^Ft, Rb, Sm, Wwt^Wkf, Wwt^Ewf, Wot, Wot, Wot^Bw|, Wot^Wkf, Wot, Wot, Wot^Wkf, Wot, Wot, Wot^Wkf, Wot, Wot, Wwt^Vhs, Rp, Rp, Ss^Fts, Ss, Gg, Ss, Ss^Bw/r, Rp, Ss, Rp
Gs^Ft, Sm, Sm^Efm, Sm, Ss, Gs^Ft, Rb, Sm^Ewf, Rb, Wot^Wkf, Wot^Wkf, Wwt^Bw|, Wwt, Wot, Wwt, Wwt^Wkf, Ss, Wot, Wot, Wot, Wot^Bw/, Wwt^Bw/, Sm, Ss, Ss, Ss, Sm^Efm, Rp, Ss, Ss, Ss, Gg
Ss, Ss, Ss^Ft, Sm^Efm, Gs^Ft, Ss, Ss^Efm, Rb, Rb, Wwt, Sm^Ewf, Sm^Bw|, Ss, Sm, Sm^Ewf, Sm, Rb, Rb, Wwt^Bw/, Wot^Bw/, Wot, Wot, Wwt^Wkf, Rb, Ss, Sm^Fts, Rp, Rp, Ss, Gs^Ft, Rb^Ft, Gg
Sm, Ss, Ss, Ss^Fts, Gs^Ft, Gg, Gg, Ss, Rb, Ds, Sm^Ewf, Rp, Ss, Ss^Ftd, Gg^Ftd, Rb^Ftd, Rp, Rp, Sm^Vhs, Wwt, Wot, Wot^Wkf, Wwt^Wkf, Rb, Gg, Rp, Rb, Ss, Ss, Rb^Ft, Rb, Rb
Sm, Gs^Ft, Sm, Ss^Ft, Rb, Ss^Efm, Ss, Ss, Gs^Ft, Gs^Fts, Rb, Rp, Rp, Rp, Rp, Rp, Rb^Ftd, Rb, Rb, Wwt, Wot, Wot, Wot, Ss, Sm^Ewf, Rp, Ds, Ds, Sm^Wkf, Rb^Wkf, Wwt^Wkf, Sm
Gs^Ft, Sm^Ft, Hh, Gs^Ft, Sm, Ss, Gg^Ftd, Gg, Sm, Ss^Fts, Rb^Ft, Rb^Ftd, Rp, Rb, Sm^Ft, Sm^Ft, Ss^Fts, Gs^Ft, Sm, Rb, Ss, Wot^Ewl, Wot, Wot, Wwt, Rp, Rp, Wwt, Ss, Wot^Wkf, Ww^Ewf, Wot
Gg, Gs^Ft, Hh^Fms, Sm, Sm, Sm, Gs^Fts, Gs^Ft, Ss, Ss, Gg^Ftd, Rb, Rp, Gs^Ft, Ss^Fts, Gs^Ftd, Ss, Sm^Ft, Sm^Ft, Ds, Rb, Wwt, Wwt^Wkf, Wot, Wot^Wkf, Sm, Wwt^Bw|, Wwt, Wot, Wot^Wkf, Wwt, Wot
Rp, Hh^Fms, Hh, Hh, Sm, Hh, Gg, Ss^Ft, Ss^Fts, Gg^Ftd, Rp, Ss, Gs^Ft, Gs^Vc, Rb^Efm, Gs^Ft, Ss, Ss^Ft, Ss, Rb, Gg^Ftd, Sm^Wkf, Sm^Ewf, Wwt, Wot, Wot, Wot^Bw|, Wot, Wwt^Wkf, Wwt, Sm^Wkf, Wot
Hh^Fms, Rp, Rp, Hh^Fms, Hh^Fms, Hh, Hh, Gs^Ft, Ss^Ft, Ss, Rp, Gs^Ft, Ss^Ft, Ss, Sm^Eff, Ss^Eff, Ss^Eff, Gg^Ftd, Ss^Ft, Ss, Ss^Ft, Rb^Ftd, Rb, Rb^Ftd, Wwt^Wkf, Wot^Wkf, Wwt^Bw|, Ss, Wwt^Wkf, Sm^Ewf, Rb, Wot
Hh, Hh^Fms, Rp, Hh^Ebn, Ket, Cer, Cer, Rb, Rb^Ebn, Rb^Efm, Rp, Ss, Ss^Eff, Sm^Eff, Gg^Emf, Gg^Emf, Ss, Ss^Eff, Sm^Eff, Ss, Ss, Rb^Fts, Gs^Ft, Gg^Efm, Ds, Sm, Rp, Sm, Ds, Rb, Sm, Rb
Hh, Hh^Ebn, Ket, Rp, Rp, Gll^Qhh, Gll^Vht, Ket, Rp, Rp, Rb^Ebn, Sm^Eff, Sm^Eff, Gg^Emf, Ss, Ss, Gg^Emf, Gg^Emf, Ss^Eff, Ss^Eff, Rb^Gvs, Ss, Ss^Ft, Gs^Ft, Rb^Efm, Gg^Efm, Rp, Gg^Vht, Rb^Ftd, Gg^Ftd, Ss, Rb
Rb, Cer, Gll^Qhh, Gll^Qhh, Rp, Gll^Qhh, Gll^Vd, Rp, Gll^Edt, Ket, Cer, Ss, Ss^Eff, Ss^Eff, Ss^Eff, Gg^Emf, Ss^Eff, Ss^Eff, Rb^Gvs, Rb^Gvs, Rb, Ss, Ss^Ft, Hh, Hh, Rp, Rb^Ft, Gs^Efm, Ss^Efm, Ss^Ft, Ss^Efm, Gg
Rb, Cer, Gll^Vht, Gll^Wm, Rp, Gll, Rp, Rp, Wwg, Gll, Cer, Gg^Eff, Ss^Eff, Rb^Gvs, Sm^Eff, Ss^Eff, Rb^Gvs, Ss, Rp, Rp, Rp, Ss^Vhs, Ss, Rb, Rp, Rp, Rb, Sm^Ft, Gs^Ft, Gg, Sm^Efm, Sm
Rb, Cer, Rp, Gll^Edt, Rp, 2 Rp, Rp, Gll^Feth, Gll, Gll^Vht, Cer, Ss, Ss^Ft, Sm^Eff, Rb^Gvs, Rb^Gvs, Rp, Rp, Gs^Ftp, Gs^Ft, Gs^Ft, Rp, Rp, Rp, Gs^Ft, Gg, Ss, Sm, Ss, Gg^Ftd, Ss^Efm, Sm
Hh^Ebn, Ket, Rp, Rp, Gll^Vd, Gll, Rp, Rp, Rp, Gll, Ket, Rb^Efm, Rb^Ft, Gs^Ft, Rb^Efm, Rp, Sm^Efm, Sm^Efm, Rb^Gvs, Gs^Ftd, Gs^Ft, Gg^Ftd, Rb, Gg^Fts, Gs^Fts, Ss^Ft, Ss^Ft, Ss^Ftd, Ss^Ftd, Ss, Ss, Sm^Efm
Hh, Rp, Rb^Ebn, Ket, Cer, Rp, Gll^Vd, Gll, Ket, Rp, Rp, Rb^Ebn, Gg^Efm, Rb^Ft, Rp, Rp, Sm, Rb^Gvs, Rb^Efm, Rb^Ft, Rb^Gvs, Ss, Ss, Gs^Ft, Gg^Ftd, Sm^Ftd, Sm^Efm, Ss, Rb, Rb^Ft, Ss, Sm
Rp, Rp, Gg, Rb, Sm, Cer, Cer, Cer, Ss, Rb^Ebn, Rp, Rb, Rp, Rp, Ss^Gvs, Gg^Gvs, Gs^Ft, Sm, Rb^Efm, Rb^Gvs, Rb, Ss, Ss^Ft, Ss, Sm, Sm, Hh, Rb, Gs^Ft, Rb^Ft, Ss^Ft, Gg
Gg, Hh^Fms, Gs^Ft, Hh, Sm, Sm, Gs^Ft, Gs^Ft, Gs^Ft, Ss, Ss, Rp, Rp, Ss, Gs^Ft, Gs^Ft, Rb^Gvs, Rb^Gvs, Ss, Ss, Rb, Ss^Ft, Ss, Gs^Ft, Rb^Ftd, Hh^Ftd, Hh, Gs^Ft, Gs^Ft, Ss, Sm, Sm
Gg, Gs^Ft, Gg, Gs^Ft, Gg, Sm, Sm, Sm, Gs^Ft, Ss, Gg, Ss, Rp, Ss, Gs^Ft, Ss, Gg, Rb, Gg, Ss, Gg, Sm^Ft, Sm, Sm, Sm, Rb, Gg, Sm, Gg, Gs^Ft, Gg, Sm
