Gg, Gg^Efm, Gg^Efm, Gg, Gg, Gg, Gg, Gg^Efm, Gg, Gg, Hh^Fdf, Gg, Gs^Fdf, Gg, Gs, Gg, Hh, Hh^Fdf, Gd, Gg, Gd, Gg, Rrc, Gg, Gg, Gg, Gs^Fdf, Gs^Fdf, Gd, Gs, Gs^Fdf, Gs^Fdf, Gs^Fdf, Gg^Fdf, Gs^Fdf, Gg, Gd, Gg^Fdf, Gs^Fdf, Gg^Fdf, Gs^Fdf, Gg^Fdf, Gs^Fdf, Gs, Gs^Fdf, Gs^Fdf
Gg^Es, Gg, Gg, Gg^Efm, Gg, Gg^Es, Gg^Fdf, Gs, Hh^Fdf, Gg, Gg, Hh^Fmf, Hh, Gg^Fdf, Hh^Fdf, Gg^Fmf, Hh, Hh^Fdf, Gg^Fmf, Gs^Fdf, Gd, Gd, Re, Rr, Gg, Gs, Gs, Gs, Gs^Fdf, Gg, Gg^Efm, Gs, Gs^Fdf, Gg, Gs^Fmf, Gs^Fdf, Gg^Fdf, Gs, Gd^Fdf, Gg^Fdf, Gg^Em, Gs^Fdf, Gs^Fdf, Gs^Fmf, Gg^Fdf, Gs^Fdf
Gg, Gg, Gg^Eff, Gs^Eff, Gg^Eff, Gg, Gg, Gg^Fdf, Gg^Fmf, Hh, Hh^Fdf, Gg^Fdf, Gg, Gs^Efm, Gg, Gg^Fmf, Gg, Gs, Gg, Gg^Fdf, Gg, Gs^Es, Re^Vh, Rr, Gg, Gg^Fdf, Gs^Fdf, Gg^Fdf, Gd^Fmf, Gd^Fdf, Gs^Fdf, Gs, Gg^Em, Gd^Fdf, Gd^Fdf, Gs^Es, Gd^Fdf, Gs^Fdf, Gs^Fmf, Gd, Gd^Fdf, Gs, Gg^Fdf, Gs^Fdf, Gs^Fdf, Gg
Gg, Gs^Eff, Rb^Emf, Rb^Emf, Rb^Gvs, Gg^Eff, Gg^Eff, Gg^Fdf, Gg, Gg, Gg, Gg, Gs^Fdf, Gg, Gg, Gs^Fdf, Gg, Hh^Fdf, Gs^Fdf, Gg^Fdf, Gs, Gg^Gvs, Re, Rrc, Gg, Gg, Gg, Gs, Gg^Fdf, Gs, Gs^Fdf, Gs^Fdf, Gs^Fdf, Gs^Fdf, Gs^Fdf, Gs^Em, Gd^Fdf, Gs^Fdf, Gs^Fdf, Gs, Gg^Fdf, Gs^Fdf, Gd^Fmf, Gs, Gd, Gg
Gg^Eff, Rb^Emf, Rb^Gvs, Rb^Gvs, Rb^Gvs, Rb^Gvs, Gg^Eff, Gg^Eff, Gg^Dr, Gg^Fdf, Gg, Hh, Gg, Gg, Hh, Hh^Efm, Gs, Hh, Hh, Gg, Gg^Efm, Gg, Rr, Rr, Gs, Gg^Efm, Gs^Es, Gs, Gg, Gg, Gg^Fdf, Gd^Fmf, Gs^Fdf, Gs^Fmf, Gd, Gg^Fdf, Gs, Gs, Gs, Gd^Fdf, Gs, Gs^Fdf, Gs^Efm, Gs^Fdf, Gs^Efm, Gg
Gg^Qhh, Gg^Eff, Gs^Eff, Rb^Gvs, Gg^Eff, Rp^Vh, Gg, Gg^Efm, Gs^Eff, Gg^Eff, Gg^Eff, Gg^Em, Gs^Em, Gg^Fdf, Gg, Hh, Hh^Fdf, Gg^Efm, Gg, Gg, Rr, Rr, Gg, Gg, Gs, Gg, Gg, Gs, Gs^Fdf, Gg^Fdf, Gs, Gs^Fdf, Gs, Gd, Gd, Gd, Gd^Es, Gs^Fdf, Gs, Gs^Fdf, Gs^Fdf, Gg, Gs^Es, Gs, Gs, Gg
Gg, Gg^Qhh, Gg, Gg^Eff, Rp^Vwm, Rp^Efm, Gg^Eff, Gs^Eff, Rb^Gvs, Rb^Emf, Rb^Emf, Gg^Eff, Gg^Eff, Gg, Hh^Es, Hh^Es, Gg, Gg, Gs^Fdf, Gg, Rrc, Re, Gg^Efm, Gg, Gg^Efm, Gs^Es, Gg, Gs^Fdf, Gg^Fdf, Gg^Fmf, Gs^Fdf, Gg^Fdf, Gd, Gd^Edp, Gll, Gll^Es, Gd, Gd, Gg^Fdf, Gd, Gg^Fdf, Gs, Gg, Gg^Fdf, Gg, Gg^Fdf
Rrc, Gg^Qhh, Gg, Rp^Efm, Gg, Gs^Eff, Gg^Eff, Rb^Gvs, Rb^Gvs, Rb^Gvs, Rb^Gvs, Rb^Emf, Gg^Eff, Gs^Eff, Gg, Gg, Gg, Gg, Gs, Gg, Rrc, Re, Gg, Gg, Gg, Gg, Gg, Gg, Gg^Es, Gg, Gg, Gg^Fdf, Gd, Gd, Rp^Vct, Gll^Edp, Gd^Es, Gd, Gs, Gs, Gg^Fdf, Gs^Fmf, Gg^Fdf, Gg^Efm, Gg, Gg
Gg, Rr, Rr, Rp^Efm, Rp, Gg, Rp^Efm, Gg^Vh, Gs^Eff, Rb^Gvs, Gg^Eff, Gg^Eff, Gg, Gg, Gg^Es, Gg, Sm^Efm, Gg, Gg, Gg, Gg, Rrc, Gg, Gg, Gg, Gg, Gg^Es, Gg, Gg, Gs^Fdf, Gs, Gs^Fdf, Gs^Fdf, Rp, Rp, Gd^Ecf, Gg, Gs^Fdf, Gg, Gs, Gg^Es, Gs, Rr, Gg, Rr, Rr
Gg^Es, Gg, Rr, Re, Gg, Rp, Gg^Es, Gg^Efm, Gg, Gg^Eff, Gg^Efm, Gs, Gg^Efm, Gg, Gg, Gg, Sm, Sm, Ss, Gg, Ket^Efs, Rrc, Ket^Efs, Gg, Sm^Wkf, Sm, Ss, Gg, Gg, Gg, Gs^Fdf, Gs, Gs, Gs, Gs, Rp, Rr, Rr, Rr, Gs, Rr, Rrc, Gs, Rr, Gg, Gs
Gg^Qhh, Gg^Qhh, Re, Rr, Gg, Gg^Qhh, Gg^Qhh, Gg^Qhh, Gg^Qhh, Gg^Qhh, Gg, Gg^Efm, Gg, Gg^Efm, Dd, Dd^Ewsh, Wog, Wwg^Ewf, Wwg, Wwg^Wkf, Wog, Wot^Bsb|, Wwrt, Wwg^Wkf, Wog, Wwg^Ewl, Wwg, Dd^Ewsh, Dd, Gg, Gg, Gs, Gg^Es, Gs, Rr, Rr, Gs, Re, Hh, Rr, Gg, Gs, Gs^Efm, Gg, Gs, Gs^Fdf
Gg^Qhh, Gg^Qhh, Gg^Qhh, Rr, Rrc, Gg, Gg, Gg, Gg^Es, Gg^Qhh, Gg, Gg, Sm, Dd^Ewsh, Wwg^Wkf, Wwg, Wog, Wog, Wog, Wog, Wog, Wog^Bsb|, Wog, Wog^Es, Wwg, Wog, Wwg, Wwg^Es, Wwg^Wkf, Sm, Sm, Gs, Gg, Re, Rrc, Gg, Gg, Hh, Hh, Hh, Gs, Gs, Gd^Fdf, Gs, Gg^Fdf, Gg
Gs^Qhh, Gg^Qhh, Gg^Es, Gg, Gg, Rr, Rrc, Re, Rrc, Gg, Ket, Gg, Wwg^Ewl, Wwg, Wog, Wog, Wog, Wwg, Wwg, Wwg^Bw\, Ch, Wot^Bsb|, Ch, Wwg, Wwg^Bw/, Wog, Wog, Wog, Wog, Wwg, Sm^Ewl, Gg, Rrc, Rr, Gs, Gs^Es, Gs, Gg^Efm, Gg, Gg^Fdf, Gg, Hh, Gs^Em, Gg^Fdf, Gs^Fmf, Gg
Gg, Gs^Qhh, Gg^Qhh, Gg^Qhh, Rp, Rp, Gg, Rrc, Gg, Rrc, Rrc, Wwrt, Wwg, Wog, Wwg, Wwg, Isr, Isr, Isr, Isr, Isr^VjO, Rrc, Isr^VjJ, Isr, Rrc, Wwrt, Wwg, Wwg, Wog, Wwg^Wkf, Ket, Gg, Rrc, Re, Gg^Es, Gg^Es, Gg^Efm, Gg, Gg, Gs, Gd^Fdf, Gg^Fdf, Gg^Em, Gg^Fdf, Gs^Fdf, Gd
Gg^Eff, Gs^Qhh, Gg^Efm, Gg, Rp, Gg, Gg, Gg, Gg, Ket, Wwg^Efs, Wot^Bsb\, Wog^Bsb\, Wog, Wwg, Wwg, Rrc, Isr^VjJ, Isr^VjP, Isr^VjN, Isr^VjP, Rrc, Isr^Vhc, Isr^VjP, Rrc, Rr^VjO, Isr, Wwg^Bw/, Wog, Wog, Wot^Bsb/, Rrc, Ket, Gg, Gg, Gg, Hh, Gg^Efm, Hh, Gg^Fdf, Gs^Em, Gs^Fdf, Gg^Es, Gd, Gg^Fdf, Gg^Fmf
Rb^Emf, Gg^Eff, Rp^Vh, Rp, Gg^Em, Gg^Efm, Gg, Gg^Es, Sm, Gg, Wwg, Wog, Wwg, Wog^Bsb\, Wot^Bsb\, Ch, Isr^VjJ, Rrc^Efs, Rrc, Isr^VjJ, Isr^VjK, Rrc, Isr^VjN, Isr^VjJ, Rrc, Isr^VjN, Isr^Vhc, Ch, Wot^Bsb/, Wog^Bsb/, Wog, Wwg^Efs, Gg^Ewsh, Gg, Gg, Gs, Gg, Hh, Hh, Gg, Gs, Gs, Gs^Es, Gg, Gg^Fdf, Gg^Fmf
Rb^Emf, Rb^Emf, Rb^Emf, Gg^Eff, Gg^Eff, Gg, Gg^Es, Gg, Dd, Wwg^Ewf, Wwg, Wog, Wog, Wwg, Ch, Rrc, Rrc, Isr^VjN, Isr^Vh, Rrc, Rrc^Efs, Rrc, Rrc, Rrc^Efs, Isr^VjJ, Isr^VjP, Rrc^Efs, Rrc, Ch, Wwg, Wog, Wwg, Wwg^Ewf, Sm, Gg, Hh, Gg, Gs, Gg^Eff, Gg^Em, Gg^Efm, Gd, Gs^Fdf, Gs^Fdf, Gg, Gg
Gg^Eff, Rb^Emf, Gg^Eff, Gg^Eff, Gs^Vwm, Gg^Dr, Gg, Gg, Dd^Ewsh, Wwrt, Wog, Wog, Wwg^Bw\, Wwg, Rrc, Isr^VjJ, Isr^VjO, Rrc^Efs, Rrc, Rrc, Ch^Efs, Ch, Ch^Efs, Rrc, Rrc, Rrc, Isr^VjJ, Isr^VjP, Rrc, Wwg, Wwg, Wog, Wwg^Wkf, Dd, Gg, Gg^Em, Gg^Eff, Gs^Eff, Rb^Emf, Gg^Eff, Gg^Eff, Gg, Gg, Gg, Gg^Efm, Gg
Rb^Gvs, Gg^Eff, Rb^Gvs, Gg^Eff, Gg^Eff, Gg^Efm, Gg, Gg, Wwg^Ewl, Wwg^Wkf, Wog, Wwg^Es, Wwrt, Isr, Isr^Vhc, Rrc, Rrc, Isr^Vhc, Rrc, Ch, Gs, Ch, Gs, Ch, Rrc, Isr^Vhc, Rrc^Efs, Rrc, Isr^VjP, Wwg^Bw/, Wwg, Wog, Wog, Ss, Gg, Gg^Eff, Gs^Eff, Rb^Emf, Rb^Emf, Rb^Emf, Gs^Eff, Gg^Eff, Gg^Eff, Gs, Gg^Fdf, Gs
Rb^Gvs, Rb^Gvs, Rb^Gvs, Rb^Gvs, Gs^Eff, Gg^Eff, Gg^Es, Ss, Wwg, Wwg, Wog, Wog^Es, Wwg, Isr, Isr^VjJ, Isr^VjN, Rrc^Efs, Rrc, Rrc, Ch^Efs, Gs, Kh, Gs, Ch^Efs, Rrc, Rrc, Rrc, Isr^VjJ, Isr^VjN, Isr, Wog, Wog, Wwrt, Gg^Ewsh, Gg, Gg, Gg^Vwm, Gs^Eff, Rp^Vh, Gg^Eff, Rb^Gvs, Rb^Gvs, Rb^Gvs, Gg^Eff, Gs^Eff, Gg
Gs^Eff, Rb^Gvs, Gg^Eff, Rp^Vh, Rp, Gg, Gg, Dd, Wwg, Wog^Wkf, Wog, Wwg, Wwg^Bw/, Isr, Rrc, Rrc, Isr^VjJ, Isr^VjP, Rrc, Ch^Efs, Ch, Ch, Ch, Ch^Efs, Rrc, Isr^VjN, Isr^VjO, Rrc, Rrc^Efs, Wwg^Bw\, Wwg, Wog, Wwg^Wkf, Dd, Gg^Es, Gg, Gg, Gg, Rp, Gg^Eff, Gg^Eff, Rb^Gvs, Gg^Eff, Gg^Eff, Gg^Efm, Gg
Gg, Gs^Eff, Gs^Es, Gg, Gg^Efm, Rp, Gg, Gg, Dd^Ewsh, Wwg, Wwg^Wkf, Wog, Wog, Rrc, Isr^VjL, Isr^VjK, Rrc^Efs, Rrc, Isr^VjJ, Rrc, Rrc^Efs, Ch, Rrc^Efs, Rrc, Isr^VjJ, Rrc^Efs, Rrc, Isr^Vhc, Ch, Wwg, Wog, Wog, Wwg, Dd^Ewsh, Gg, Gg, Gg^Efm, Gg, Rp, Gg, Gg^Es, Gs^Eff, Gg, Gg, Hh, Hh
Hh, Hh, Gg, Gg, Gg, Rp, Rp, Gg, Gg, Wwg^Ewl, Wwg, Wog, Wwg, Ch, Rrc, Rrc, Isr^VjP, Isr^VjO, Isr^Vhc, Rrc, Isr^VjJ, Rrc, Isr^Vhc, Rrc, Rrc, Isr^VjN, Isr^VjJ, Rrc, Wot^Bsb\, Wwg, Wog, Wwg^Wkf, Sm^Ewl, Sm^Ewl, Sm, Gg, Gg^Efm, Gg, Gs, Rp, Gg, Gg^Es, Hh^Es, Hh, Hh, Gg
Hh, Gs^Fmf, Gg, Hh, Hh^Fds, Gg^Efm, Rp, Gg, Gg, Sm, Ket, Wog, Wog^Bsb/, Wot^Bsb/, Wwg, Ch, Isr, Isr^VjJ, Rrc^Efs, Rrc, Isr^VjN, Rrc, Isr^VjN, Isr^Efs, Isr^VjO, Rrc, Rrc, Ch, Wwg, Wog^Bsb\, Wot^Bsb\, Wwg, Ket, Sm, Gg, Gg, Gg, Gg, Gg, Rp, Gg, Gg, Gg, Gg^Efm, Gg, Gg
Gg, Hh^Fmf, Hh^Fds, Hh, Gg^Fmf, Gs, Gg^Fmf, Rp, Rp, Gg, Rrc^Efs, Wot^Bsb/, Wwg, Wog, Wog, Wwrt, Wwg, Isr, Wwg, Isr^VjP, Ch, Rrc, Ch, Isr^VjJ, Wwg, Isr^VjJ, Wwg^Bw\, Wwg, Wog, Wog, Wwg^Efs, Rrc^Efs, Rrc, Gg, Gg, Gg^Es, Gg, Hh, Gg, Rp, Rr, Gg^Es, Gg, Hh, Gg, Gg
Mm, Mm, Hh^Efm, Gg, Hh, Hh, Hh^Fmf, Gg, Rrc, Rrc, Gg, Ket^Efs, Sm, Wwg^Wkf, Wog, Wog, Wog, Wog, Wog, Wwg^Bw/, Wwg, Wot^Bsb|, Wwg, Wwg^Bw|, Wog, Wwg, Wwg, Wwg, Wog, Wwg, Gg^Ewsh, Ket, Gg, Rr, Rrc, Rr, Rrc, Re, Rrc, Rr, Re, Rr, Rr, Gg, Rr, Gg
Gg, Mm, Hh^Es, Hh^Fmf, Hh, Gg, Gg^Es, Re, Rr, Gg, Gg^Efm, Gg, Gg, Wwg, Wwg^Wkf, Wog, Wwg, Wog, Wwg, Wog, Wog, Wog^Bsb|, Wog, Wog, Wog, Wog, Wog, Wog, Wog, Wwg, Dd, Gg, Gg, Gg^Efm, Gg, Re, Gg, Rrc, Re^Es, Gg^Efm, Hh, Gg, Gs^Es, Rrc, Gg, Rr
Gg, Hh^Fmf, Gg^Fds, Gg, Hh^Fds, Gg, Gg, Rrc, Re, Hh, Gg, Gg, Gg, Ss, Dd^Es, Wwg, Dd, Wwrt, Ss, Gg, Ket, Wot^Bsb|, Ket, Wwg, Wwg^Wkf, Wog, Wwg^Ewl, Wwg, Wog, Wwg, Wwg, Dd, Gg, Gg, Ss, Sm^Ewl, Sm, Gg, Gg, Re, Re, Gg, Gg, Gg, Gg, Gg
Gg, Gs^Fmf, Hh^Efm, Gg^Es, Re^Vh, Gg, Rrc, Rr, Gg^Es, Gg, Gg^Efm, Hh, Gg, Gg^Es, Gg, Dd, Gg, Sm^Ewl, Gg, Gg, Gg^Efs, Rrc, Gg^Efs, Gg, Sm, Wwg^Ewl, Dd, Sm, Wwg^Wkf, Wog, Wog, Wwg^Ewf, Wwg, Wwg, Wog, Wwg, Wwg^Ewf, Wwg, Ss, Hh, Hh, Re^Efm, Hh, Hh^Es, Gg^Efm, Gg^Efm
Gg, Hh, Gg, Gg, Rr, Rr, Gs^Fmf, Gg, Gg^Es, Gg^Fds, Gg, Gg, Gg^Efm, Gg, Gg^Fmf, Gg, Gg^Es, Gg, Gg, Gg^Es, Gg, Rrc, Gg, Gg, Hh, Sm, Gg^Es, Gg, Ss, Wwg, Wwg^Ewf, Wog, Wog, Wog, Wwg, Wog, Wog, Wog, Wwg^Wkf, Gg^Gvs, Re^Vh, Re, Gg^Em, Hh, Sm, Gg
Gg, Gg, Re, Hh, Rr, Re, Gs^Fds, Gs^Fds, Gs^Fmf, Gg, Gs^Fds, Gs^Fmf, Gg, Gg, Gg^Es, Gg, Gg, Gg, Gg, Gg, Rr, Rr, Gg, Gg, Gg^Efm, Gg, Gg^Fds, Gg^Fds, Gg, Ss, Wwrt, Wwg, Dd, Wwg, Wwg, Wog, Wog, Wog^Wkf, Wwg, Rrd, Dd^Ewsh, Gg^Es, Dd, Gg, Wwg^Ewl, Sm
Rr, Rr, Rr, Rr, Gs^Fds, Re, Re^Efm, Gg, Hh^Fds, Gg, Hh^Fds, Hh^Fds, Hh, Gg^Fds, Gs^Fds, Gg^Efm, Gg^Gvs, Gg^Fmf, Re, Gg^Efm, Rr, Re, Gg^Es, Hh, Gg, Gg, Hh, Hh^Fds, Gg^Fds, Gg, Gg, Sm, Hh, Dd, Ss^Wkf, Wwg, Wwg, Wog, Wog, Wwg, Wwg^Wkf, Wwrt, Wwg^Ewf, Wwg, Wwg, Wwg
Gg, Re, Gg, Gg, Hh^Efm, Hh, Gs^Fds, Re, Re^Vh, Gs^Fmf, Gs^Fds, Gg^Efm, Gg, Hh^Fds, Gs^Fmf, Gg, Gg^Fds, Re^Vh, Re, Re, Rr, Re, Gg, Gg, Gg^Fmf, Re^Vh, Re, Hh^Efm, Re, Hh, Gg^Efm, Gg, Re, Re^Vh, Wwg, Ss, Wwg, Wog, Wog, Wwg, Wwg^Es, Wwrt, Wog^Es, Wog, Wwg^Wkf, Wwg
Gs^Fds, Gs^Fds, Gs^Fds, Gs^Fmf, Hh, Gg, Gs^Fmf, Hh^Fds, Gg^Efm, Hh^Fds, Gs^Fmf, Gs^Fmf, Hh^Fds, Gs^Fds, Gs^Fds, Gg, Gg^Fmf, Gg, Gg^Fds, Gg, Gg^Es, Rr, Rrc, Gg, Re, Re, Gg^Fds, Re, Gg^Es, Re^Efm, Re, Re, Dd, Wwg^Ewf, Wog^Wkf, Wwg^Wkf, Wwg, Wwg, Wog, Wog, Wog, Wog, Wog, Wog^Wkf, Wwg, Wwg
Gg, Gg, Gg, Gg, Gs^Fds, Gs^Fds, Gs^Fds, Gs^Fds, Gs^Fds, Gg^Efm, Gs^Fds, Gs^Fds, Gs^Fds, Gs^Fmf, Gs^Fds, Gg, Gg, Gg, Gg, Gg, Gg, Gg, Gg, Rr, Gg, Gg, Gg, Gg, Gg, Hh, Gg, Gg, Wwg, Wwg, Wwg, Wog, Wog, Wog^Wkf, Wog, Wog, Wog, Wog, Wog, Wog, Dd, Dd
